𒌅𒃼𒆗	STB
𒁹𒅆𒂟𒄿𒄩𒊓𒋢𒁍𒈝𒆳𒌵𒆠	STB
𒉌𒊏𒍦𒉿𒇽𒂟𒈨𒌍𒊭𒂗𒉣𒀸𒊮𒁉	NEA
𒅇𒇽𒀀𒆥𒃻𒀀𒈾	NEA
𒉺𒊑𒄑𒌅𒈗𒇺𒁍𒊏	NEA
𒁹𒈬𒀀	LTB
𒀉𒍣𒁕𒍝	SUX
𒂊𒁕𒋡	SUX
𒅖𒌅𒋡𒋾𒋗	MPB
𒊭𒀭𒌓𒆷𒈠𒍝𒋗	OLB
𒈠𒀀𒇽𒂟𒈨𒌍𒌋𒌋𒉌𒉡𒊭𒊍𒁉𒀉	NEA
𒀉𒋫𒉡𒌋𒌋𒋙𒅇𒀀𒁺𒌑𒇽𒀀𒆥𒈨𒌍𒋙	NEB
𒌀𒀭𒂗𒍪𒅎𒄥𒀭𒉌	OLB
𒀀𒄷𒉌	SUX
𒅇𒋗𒉡𒁕𒀠𒄷𒀀𒈾𒆳𒋙𒉡	NEA
𒍝𒀀𒌓𒀉𒋫𒁷𒆬𒌓𒀀𒀭𒊹𒂆𒉚𒄑𒊒𒁀𒈬𒈨𒌍	LTB
𒂊𒋼𒅆𒀀𒈾𒅕𒍣𒋾	MPB
𒊭𒀭𒋗𒈾𒉿𒅕𒁺𒃮	OLB
𒈗𒂗𒅀𒋡𒁺	MPB
𒂟𒈨𒌍𒌷𒊺𒄴𒆷𒇷𒆠𒅇𒌑𒊺𒄑𒍣𒉺𒋗𒉡	MPB
𒅇𒀀𒄭𒀀𒁴	OLB
𒊭𒀸𒅆𒌓𒋼	NEA
𒈗𒄑𒄖𒍝𒌑𒆷𒁇	STB
𒅅𒁉𒅆𒁺𒃻𒆠𒂗𒈨𒌍𒄩𒆷𒈨𒌍𒋙𒃮𒁉𒀀𒈾𒊹𒂆𒆬𒌓	LTB
𒁹𒀭𒋾𒀪𒄿𒆪𒋢𒉽𒁀𒉡𒌑𒌅𒀀𒈾𒉚𒌀𒈨𒌍	LTB
𒃷𒉆𒌉𒅟	SUX
𒊓𒀀𒊑𒀸𒊮𒁉𒂍𒃲𒊭𒈗𒂗𒅀𒇻𒌑𒁕	NEA
𒀀𒊮𒁖𒁀	SUX
𒈨𒌍𒊹𒉽	NEA
𒅀𒀀𒉡𒀉𒌅𒀭𒉌𒌅𒄿𒈾𒇷𒂊𒀀𒉌𒄑𒊓𒆪𒌓𒊬𒊒	STB
𒅆𒌓𒋾𒃻𒀀𒈾𒈗𒁁𒉌𒅀	NEB
𒊒𒊏𒀀𒋃𒋾𒅆𒄿	NEB
𒀸𒂗𒆤𒆠𒄷𒁺𒁹𒌋𒅗𒌦𒋡𒀀𒋾𒌋𒀴𒈨𒌍	NEB
𒁹𒋾𒄀𒆷𒀀𒈾𒀭𒁮𒆠𒈾	OLB
𒌋𒀭𒀫𒌓𒋗𒈝𒃻𒈗𒂗𒅀	NEB
𒅀𒀪𒉡𒌋𒀸𒆍𒀭𒆠	NEB
𒀀𒈾𒈗𒊑𒆠𒋫𒈠𒉿𒌍𒈨	MPB
𒊹𒀯𒀭𒋫𒋩𒊏	STB
𒃷𒉺𒋼𒋛𒅟𒅟	SUX
𒌓𒈬𒋗𒀀𒌅	STB
𒆳𒄘𒃻𒃻	SUX
𒃻𒋗𒀭𒂗𒍪𒊺𒈪𒉺𒂍𒀀𒋛𒊑	OLB
𒀭𒊹𒃻𒈠𒌍𒁇𒋙𒀀𒈾𒈗𒆠𒊹𒊏	STB
𒄿𒇻𒅈𒆪𒌑	STB
𒃻𒈪𒋻𒀸𒂍𒅎𒍇𒇻𒌋𒊑𒁍𒌑𒀸𒂍𒆪𒊑𒈬𒈨𒌍𒌋	LTB
𒌌𒅅𒄒𒁀𒋢𒈠	NEB
𒌨𒊏𒅇𒈬𒊭	MPB
𒀭𒈗𒍪𒀊𒈫	SUX
𒁺𒌒𒇻𒅖𒁺	STB
𒊹𒈾𒉌𒄿	NEA
𒅎𒌉𒈗	NEB
𒈠𒀀𒁓𒀀𒈾𒆪𒀸𒊮𒁉𒀭𒉌𒌓	NEA
𒅇𒀭𒈨𒌍𒊭𒋀𒅀𒇷𒄑𒍪𒊒𒋗𒉡	MPB
𒀸𒊮𒁉𒀭𒈨𒌍𒅟	NEB
𒊺𒍮𒌑𒊭𒈗	NEA
𒁹𒀭𒌓𒅖𒈨𒀭𒉌	OLB
𒁄𒆳𒋙𒌓𒂗𒂖	STB
𒀀𒁉𒅀𒋀𒅀𒇷𒄿𒋼𒅕𒀭𒉌𒆠𒄿𒈨𒂊𒋀𒅀𒊏𒀪𒈬𒋾𒌑𒃲𒇴	MPB
𒀠𒋫𒁇𒋗𒅇𒁾𒉺𒀀𒈾𒋡𒋾𒋗𒀜𒋫𒁷𒀸𒋗𒅇𒁾𒉺𒋀𒅀	MPB
𒀸𒊺𒀭𒇽𒌣𒈠𒆤	SUX
𒀸𒀸𒊺𒄥	SUX
𒊕𒁉𒈫𒄰𒉌𒉌𒀀𒁉	SUX
𒂊𒊒𒌑	STB
𒄿𒈾𒄑𒈪𒆪𒉡𒊹𒀭𒂗𒁷𒀉𒊑	NEB
𒌌𒌅𒀸𒉺𒉌𒐊𒄷𒁺	NEB
𒉿𒊹𒅟𒇻𒆷𒋫𒊓𒄷𒊏	NEA
𒈨𒀀𒁍𒄩𒁺𒋫	SUX
𒊹𒇽𒄿𒌓𒀪𒊹𒇽𒋡𒄯𒊏	NEA
𒊭𒂍𒃲𒊭𒀀	NEA
𒄿𒋻𒊓𒋢𒄷𒌓𒊮𒂟𒉌𒊮𒈗𒄭𒂵	STB
𒈦𒊬𒂍𒆕𒀀	SUX
𒌷𒈾𒀜𒁀𒄣𒆠	OLB
𒀀𒉈𒀭𒌓	OLB
𒁀𒊑𒂵𒁀𒊑𒂵𒍥𒍑	OLB
𒊍𒍝𒁁𒅇𒀀𒈾𒆪	NEB
𒀀𒈾𒄊𒈨𒌍𒈗𒊑𒂗𒅀	MPB
𒇽𒈾𒁷𒈾𒀭𒂍𒈬𒈨𒌍	LTB
𒇽𒈦𒀪𒀀𒀀𒀀𒈾𒌋𒅗𒄭𒋙𒉡	NEB
𒋗𒊹𒇽𒁾𒊬𒌉	STB
𒌋𒁹𒋛𒇻𒆪𒈗𒈨𒌍	LTB
𒈨𒄿𒉡𒈠	MPB
𒊹𒀀𒁲𒊹𒌑𒈥𒊩𒈠𒀀𒈾	LTB
𒆍𒃲𒌷𒅀𒇽𒉽𒀸𒃼	STB
𒀀𒈾𒁉𒈩𒀀𒇉𒀀𒈾𒋫𒁉𒂊𒋙	NEB
𒀸𒀊𒋾𒍢𒇷𒀀𒄭𒂊𒆷𒋼𒊐𒋙	STB
𒀭𒀊𒁀𒋗	SUX
𒄿𒋼𒁍𒍑𒊹𒈗𒄭𒄊𒀭𒉌𒇽𒄥𒁍𒌓	NEB
𒌉𒊩𒃻𒀀𒃻𒀀𒀸𒄷𒌓𒊮𒁉𒋙	LTB
𒁹𒁁𒇷𒍪𒉡	OLB
𒌉𒃻𒀀𒁹	LTB
𒇳𒆸𒈦	SUX
𒅖𒌅𒄭𒂵𒊑𒆠𒅀𒅖𒌅𒊹𒌗	MPB
𒌷𒂍𒅈𒄩𒄿𒉡𒈠𒉿𒁕𒃲	MPB
𒆍𒃲𒀭𒌓𒃻𒆠𒆗𒀕𒆠𒊹𒌑𒍑𒀭𒌑𒅎𒈥𒌅𒁕𒆠𒊒𒁀𒀪𒃻𒌉𒈨𒌍𒃻	LTB
𒊹𒀭𒂗𒈬𒋙	NEB
𒅇𒊹𒇽𒌉𒈨𒌍𒆕𒈨𒌍𒃻𒂗𒆤𒆠	NEB
𒈠𒀜𒅆𒈬	SUX
𒀭𒈩𒇴𒋫𒌓𒁺𒀀𒋗	SUX
𒀕𒆠𒌗𒁇𒌓𒊹𒈬𒊹𒁹𒁲𒂊𒁁𒊑𒋢𒈗	LTB
𒄿𒈾𒂔𒄿𒊐𒁉𒄑	STB
𒁹𒂊𒊺𒄿𒉺𒉌𒀭𒌓	OLB
𒊹𒃻𒌓𒈬𒀸𒊹𒌓𒈬𒀸𒌓𒊹	LTB
𒆗𒈬𒀭𒈾𒄖𒊌𒋡𒉌𒂊𒌓𒀊𒀊𒈨𒌍𒌋𒊩𒈠𒃮𒁉𒃻𒀀𒈾𒅆𒅖𒋙𒃻𒌓𒈬	LTB
𒀀𒁺𒂍𒈗𒁁𒉌	NEA
𒀸𒊹𒌓𒈬𒀸𒌓𒈬𒈨𒌍𒈬𒈨𒌍𒄑𒊒𒁀𒋙𒇽𒉌𒋩𒌑𒌓	LTB
𒊹𒁁𒉌𒀀𒀉𒁲𒉌𒋀𒌑𒀀	NEB
𒀀𒈾𒆪𒀸𒌓𒈨𒋙𒀸𒈠𒁖𒌓𒃻𒈗𒊹𒀭𒍝𒂷𒂷𒌷𒁀𒀉𒋾	NEB
𒈗𒁷𒌁𒆠	NEB
𒇽𒀀𒁀𒈨𒌍𒋫𒋗𒊹𒈗	NEA
𒀸𒂗𒆤𒆠𒀀𒈾𒇽𒀴𒈨𒌍	NEB
𒀀𒈪𒇻𒌑𒋫𒊭𒅟𒀭𒈾𒅁𒋗	MPB
𒇽𒈨𒌍𒌈𒀀𒈾𒊭𒀀𒋗𒍝𒁁	MPB
𒄈𒍪𒆠𒅟	SUX
𒂊𒇷𒀸𒋩𒀭𒌓𒌷𒂅𒊒𒍑𒉺𒀀	NEA
𒊭𒂍𒋼𒊮𒁉	NEA
𒈨𒌍𒀀𒃻𒊹𒀸𒁾𒉿𒄩𒆷𒀀𒈾𒊹𒀜𒋙𒅖𒆲	LTB
𒋡𒁺𒁮𒈨𒌍𒋾𒋗𒀸𒊭𒋼𒂊𒋗	MPB
𒅇𒌑𒌒𒉺𒆷𒄠𒀀𒈠𒋼𒈨𒌍	MPB
𒆠𒇽𒋀𒈨𒌍𒋙𒅇𒂗𒈨𒌍𒄩𒆷𒈨𒌍𒋙𒃮𒁉𒀀𒈾𒊹𒂆𒆬𒌓	LTB
𒀀𒉿𒀜𒈗𒊑	MPB
𒌋𒀀𒃻𒀀𒃻𒀀𒈨𒌍	LTB
𒇽𒃲𒉺𒇻𒈨𒌍𒃻𒀭𒀝𒀉𒋫𒁷	NEB
𒉆𒄩𒅈𒋾𒅇𒁁𒂖𒋗𒉡	OLB
𒅔𒄖𒊒𒍮𒁀𒌈𒆷𒁉𒊒	STB
𒀏𒆠𒌷𒆠𒉘𒂷𒉌	SUX
𒁁𒇷𒅀𒀀𒁲	MPB
𒅇𒁹𒄩𒉌𒂊𒋻𒄖𒈠𒀭𒈾𒋗	MPB
𒈬𒌦𒍏𒄀𒈾	SUX
𒂗𒅀𒇷	NEA
𒈪𒉡𒉿𒈾𒍣𒊏𒉌𒀀𒄯𒄿𒈾	MPB
𒄿𒁕𒌅𒊌𒅟	NEA
𒁹𒀭𒌓𒋩𒇽𒋃𒀀𒃻𒀀𒃻𒀀𒀕𒆠𒌗𒀊	LTB
𒌑𒊩𒇴𒋀𒌑𒀀𒁾𒉿𒋙	NEB
𒊹𒆗𒁉𒌑𒆪𒌑𒀀	NEA
𒃻𒈾𒋆𒇷𒃻𒀭𒀭𒈾𒀀𒆕𒍑𒈠	STB
𒀀𒈾𒉻𒇽𒄭𒃻𒆠	OLB
𒇽𒍑𒁇𒍦𒋥𒊹𒄩𒀀𒀀	NEA
𒀀𒈾𒄊𒈨𒌍𒁉	MPB
𒊹𒀸𒌗𒆥𒅎𒋛𒁲𒆳𒋥𒈠𒅋𒋃	STB
𒊹𒈗𒇻𒌑𒁕𒀀𒊒𒄿𒋼𒁍𒍑𒀀𒆳𒈗𒅆𒄿	NEB
𒃻𒀸𒆠𒁴𒂍𒀭𒅎𒃻𒆠𒆗𒀕𒆠𒊹𒌑𒍑𒀭𒌑𒅎𒋛𒁲	LTB
𒇽𒆥𒈾𒋙𒋀𒈨𒌍𒋙	NEB
𒀀𒈾𒆠𒁉𒃻	OLB
𒅇𒊮𒌓𒋰𒁉𒋗𒉡	OLB
𒀀𒄖𒌑𒃻𒆷	NEB
𒋫𒋙𒁲	NEB
𒉺𒆷𒋢𒀀	STB
𒊭𒅖𒋫𒌓𒈗𒀀𒈾	MPB
𒈦𒅟𒈾𒀀𒋾𒋙𒉡	NEB
𒄿𒊬𒊏𒁍𒅆𒅇𒀀𒈾𒈠𒄯𒁹𒀀𒈠𒀭𒄩𒀜𒁉	MPB
𒀴𒅟𒊹𒀭𒀝𒅅𒁉	NEB
𒁹𒋛𒇻𒆪𒉽𒁀𒉡𒌑𒌉𒊩𒃻	LTB
𒅇𒀲𒆳𒈨𒌍𒍪𒌑𒍣𒈠	MPB
𒊑𒋗𒄑𒄭	MPB
𒈗𒁁𒉌𒇺𒀪𒆷	NEA
𒊺𒉻𒈨𒌍𒋫𒌋𒅗𒀀𒇉	NEA
𒆳𒄭𒀀𒈗𒀀𒉡𒈠𒆏𒁉	MPB
𒌓𒈨𒌍𒁍𒁕𒈨𒌍𒈬𒀭𒈾𒈨𒌍	NEB
𒉆𒄩𒅈𒋾𒊹	OLB
𒄿𒉡𒈠𒋾𒉡𒅇	MPB
𒆳𒌵𒆠𒅇𒆳𒆳𒃮𒁉𒍢𒁍𒋫𒀀	NEB
𒀀𒃻𒀀𒃻𒇽𒆠𒌋𒌋𒌈	LTB
𒈗𒁁𒇷𒀀𒈾𒍠𒌋𒆏	NEA
𒊹𒈪𒊓𒄠𒈬	STB
𒀭𒂗𒀭𒉺	NEA
𒌗𒀊𒌓𒁺𒌓𒄰	OLB
𒄿𒇷𒀪𒀀𒈾𒇽𒃻𒌆	NEB
𒁄𒈗𒌀𒊩𒉽𒀸𒆳𒅅𒅆	STB
𒄑𒆵𒆠𒆤	SUX
𒃻𒌉𒊹𒅀𒋫𒄿𒇻	NEB
𒂗𒈾𒀀𒈾𒁷𒌁𒆠	NEB
𒀀𒃻𒊹	LTB
𒊭𒄿𒈾𒋫𒅈𒁀𒍢	OLB
𒈠𒀀𒇽𒆗𒁕𒀀𒀀	NEA
𒊹𒀯𒌋𒌆𒌈𒁺𒁍𒆳	STB
𒌑𒁄𒀉𒋾𒋗	MPB
𒊭𒄑𒅆𒌑𒉌𒈗𒂗	NEA
𒈦𒁕𒊑𒀀𒁀	SUX
𒌑𒊏𒁺𒉌𒉌𒄿𒄷𒄭𒌓	NEA
𒌋𒆕𒋡𒊒𒀀𒂵𒀀	NEB
𒅋𒇷𒆠𒄠𒈠	OLB
𒄑𒊒𒁀𒈬𒈨𒌍𒌉𒃻𒊹𒌋𒇽𒂗𒈨𒌍𒄩𒆷𒈨𒌍𒋙𒉡𒃮𒁉𒀀𒈾𒈦𒈠𒈾	LTB
𒃻𒌉𒊩𒃻𒂼𒃻𒌉𒃻𒃻𒁕𒊑𒈬𒈨𒌍𒃻𒁲𒋥	LTB
𒁀𒊑𒂵𒁀𒊑𒂵𒑏𒑏𒑏𒍥𒁕𒀀𒈾𒆠𒁉𒃻	OLB
𒊹𒊹𒀸𒅆𒇲𒋙𒋛𒈨𒌍𒋙𒀉𒁕	STB
𒀸𒆳𒌑𒈨𒀀𒀠𒆷	NEA
𒁕𒀀𒀀𒈝𒄷𒊏𒍮	STB
𒀸𒌷𒂊𒁲𒋾𒅅𒋻𒁀𒀀𒉌	NEA
𒈠𒀀𒌉𒋗𒀸𒊮𒂍𒃲𒂊𒊐𒌑𒍝	NEA
𒁹𒍣𒅎𒊑𒁕	MPB
𒅖𒋫𒃶𒉡𒌋𒋀𒋙𒌋𒋀𒋙𒀀𒈨𒌍	LTB
𒀀𒈾𒊹𒂄𒈬𒂗𒇻𒍑𒈨	NEB
𒊩𒌆𒂗𒈾𒆤	SUX
𒀀𒈾𒌉𒃻𒌉𒃻𒀀𒈾𒌓𒈬𒍝𒀀𒌓𒈾𒋗𒌑	LTB
𒁹𒀭𒂗𒍪𒊑𒈨𒉌	OLB
𒌉𒃻𒀀𒀕𒆠𒌗𒁈𒌓𒊹𒈬	LTB
𒀀𒈨𒌍𒃻𒀀𒃻𒀀	LTB
𒌷𒁺𒆷𒋾𒁲𒂗𒆗𒂵	MPB
𒆠𒌨𒀭𒈨𒁶𒁺𒋫	SUX
𒊹𒀯𒊕𒈨𒃻𒀸𒈪𒋚𒀭𒉺𒉈𒊕𒁺	STB
𒉡𒊌𒀀𒌨𒈬𒄯	NEA
𒁼𒄑𒄖𒍝𒈗𒋾	NEB
𒆠𒄿𒃻𒍝𒇴𒃻𒃮𒋭𒀸𒉈𒅖𒊬𒊐𒌋𒉌	STB
𒀀𒃮𒁉𒉈𒈬𒊭𒆍𒀭𒊏𒆠	NEA
𒅇𒋀𒈨𒌍𒂊𒀀	NEB
𒁹𒀭𒈾𒈾𒀀𒈬𒆠𒊒𒁀𒀀𒈬𒈨𒌍𒌑𒈥𒊩𒄣𒈠𒀀𒁲𒊹	LTB
𒌓𒊹𒄰𒌓𒊹𒄰	STB
𒆤𒋾𒄿𒋫𒈬	STB
𒂍𒈹𒂠	SUX
𒊭𒌑𒁀𒀠	MPB
𒊍𒍢𒅂𒅇𒄯	NEB
𒇽𒂍𒀀𒁀𒌀	SUX
𒂗𒅀𒋗𒇻𒄴𒋫	MPB
𒆷𒌑𒉘𒈬𒈾𒀀𒅆	NEA
𒆷𒉺𒀭𒆳𒈠𒆷𒌒𒁄𒌑𒀀𒈾𒈗	NEB
𒌓𒁀𒀩𒈾𒉌	SUX
𒊭𒀲𒆳𒊏𒈨𒌍𒅟	MPB
𒂗𒀀𒁲𒉌𒋙𒇷𒁍𒍑	NEB
𒊮𒁉𒃻𒈗𒁁𒉌𒅀𒇷𒁳	NEB
𒈗𒁁𒉌𒅀𒈜𒌨𒀭𒀝𒌋𒀭𒀫𒌓	NEB
𒁹𒄿𒋛𒋼𒌑𒋢	LTB
𒆠𒄿𒊭𒈗𒁁𒉌𒅅𒁍𒌋𒉌	NEA
𒀭𒊩𒌆𒅟𒉌𒋗	SUX
𒅇𒉿𒂖𒈠𒀜𒈗𒊑	MPB
𒄑𒋡𒋾𒀸𒉺𒉌𒀭𒃽𒃻𒀕𒆠	NEB
𒇽𒁈𒉺𒇻𒆠𒈨𒌍	NEB
𒌑𒋼𒅕𒊒𒉌𒅖𒋗	OLB
𒁹𒉌𒅔	OLB
𒀀𒈾𒊩𒍑𒁇𒈨𒌍	OLB
𒁹𒀭𒋙𒈬𒌶	LTB
𒌉𒇽𒀭𒊩𒌆𒄈𒋢𒆯	SUX
𒂗𒉣𒌓𒉌𒆷𒊬𒈠𒑚𒂗𒉣𒄴𒄭𒊒𒀸𒂗𒉣𒌓𒉌𒆷	STB
𒄶𒄶𒃷𒊹𒊹𒊹𒊹𒊹𒊹𒊹𒁓𒁓𒁓𒌋𒌍	SUX
𒊹𒊭𒁺	NEA
𒅇𒁕𒂍𒀭𒈠𒀭𒋧	SUX
𒆳𒋼𒀀𒈬𒌓𒁺𒀝	STB
𒄿𒉡𒈠𒄿𒅋𒆷𒂵𒄠	MPB
𒀯𒉺𒉈𒊕𒅆𒅕	STB
𒃻𒁀𒈗𒀀𒈾𒀭𒌓	OLB
𒉻𒂍𒀀𒋛𒊑𒍣𒂵	OLB
𒉡𒁕𒈬𒌑𒌇	STB
𒍝𒀊𒋫𒀜	MPB
𒀀𒈾𒂍	NEB
𒆕𒄣𒊒𒈠𒋾𒄴𒀀𒈾𒄩𒁕𒁲	NEA
𒃻𒋛𒁲𒉌𒂠	SUX
𒌉𒀭𒊏	OLB
𒅇𒋖𒀊	SUX
𒅎𒋫𒇯𒁺	SUX
𒁹𒌷𒁀𒄠	OLB
𒀴𒀭𒄿	OLB
𒀸𒌓𒊹𒄑𒊒𒁀𒅆𒊹𒀭𒌈𒀭𒈹𒀭𒈾𒈾𒀀	LTB
𒊩𒀲𒂼𒃶	SUX
𒌑𒈥𒊩𒈠𒀀𒁲𒊹𒀀𒈾𒀀𒃻	LTB
𒉽𒁀𒉡𒌑𒌓𒀀𒈾𒉚𒌀𒈨𒌍𒀀𒈾𒌉𒃻	LTB
𒊒𒈠𒋥𒋢	NEB
𒁮𒁹𒀭𒈾𒈾𒀀𒈬𒇽𒈾𒁷𒈾𒀭𒈬𒈨𒌍𒅇𒆠𒊒𒁀𒀀𒃻	LTB
𒅟𒀀𒁺𒊹𒌑𒀀𒈾𒊹𒌑𒅇𒊹𒌑𒈨𒌍𒃻𒊹𒌑𒇻𒊑𒀀𒈾𒌋𒅗	STB
𒀸𒄑𒇀𒀀𒈾	NEB
𒈗𒀭𒌒𒁕	SUX
𒁲𒈠𒆜𒆷𒉌𒋫	SUX
𒀀𒊮𒃷𒀭𒊩𒌆𒄈𒋢𒅟𒅟	SUX
𒂷𒁾𒁀	SUX
𒊩𒌆𒌷𒆬𒄀	SUX
𒇷𒂊𒁍𒍑	NEA
𒋧𒈠𒈗𒁁𒉌	NEA
𒄿𒃮𒁍𒌑𒌝𒈠𒇻𒆥𒉡𒋙	NEB
𒍨𒉻𒆬𒌓𒅆𒈾𒆬𒌓𒋗𒌑𒉡	STB
𒌉𒈾𒁲	SUX
𒅇𒌑𒌌𒀉𒋾𒈗𒂗𒅟𒀜𒁕	MPB
𒊮𒊹𒇽𒀀𒋛𒀸	OLB
𒀭𒂗𒍪𒁁𒂖𒉌𒉌𒊹𒊕𒊩𒆳𒀴𒊭𒀭𒀫𒌓𒈾𒈲𒉺𒀀𒇉𒀀𒋩𒀸	OLB
𒊭𒀀𒈾𒉺𒉌𒋙𒅋𒆷𒃶𒉌	NEA
𒇽𒋻𒋫𒉡	NEA
𒁁𒉌𒀀𒅁𒆠𒆗𒉌𒀀𒁲𒌋𒅗𒃻𒂗𒈾	NEB
𒀀𒈾𒈗𒁁𒉌𒐊𒀉𒆗𒉡	NEB
𒊩𒌆𒋙𒀉𒋾𒆳𒉏𒈠𒆠𒆠𒄿𒄿𒊒𒁀	NEB
𒌗𒀾𒀀𒅟𒉌𒇲𒂊	SUX
𒄑𒊒𒁀𒈬𒈨𒌍𒀀𒁲	LTB
𒄑𒈣𒈨𒌍𒋙𒉡	NEA
𒌗𒊻𒋢𒆗𒈬𒀭𒈾	LTB
𒂊𒋼𒁍𒊻𒍪𒉡𒆠𒄿𒇻𒌑𒄩𒋚𒁹𒈠𒉌𒂊𒌌𒄿𒈠𒀀𒀜	MPB
𒊹𒂆𒆬𒌓𒋡𒇻𒌑𒀀𒈾𒊹𒈬𒈨𒌍𒄿𒉆𒁷𒌋𒊩𒈠	LTB
𒀴𒋗𒅇𒇷𒅖𒁍𒌨𒇽𒈨𒌍𒉿𒄿𒈠𒀀𒈾	MPB
𒀀𒁲𒆷𒊹𒈗𒇻𒌑𒁕𒀀𒊒𒀀𒈾𒄩𒍝𒉡𒌅	NEB
𒌋𒌋𒋙𒌋𒌋𒆳𒀸𒆠	STB
𒀲𒆳𒊏𒈨𒌍𒀀𒋫𒄯	NEA
𒊮𒅆𒊒𒁕	SUX
𒉆𒈤𒍪𒀊	SUX
𒈬𒈨𒌍𒇽𒋋𒌑𒌓𒀉𒋰𒋗𒈠𒊹𒋀𒋙𒀀𒃻	LTB
𒈗𒊑𒀭𒌓𒀸𒋫𒌓𒀀𒈾	MPB
𒁹𒀀𒄩𒋫𒉌	OLB
𒀀𒈾𒌓𒈬𒍝𒀀𒌓𒈾𒋗𒌑𒂍𒈬𒈨𒌍𒃻	LTB
𒀉𒋫𒋃	NEA
𒄿𒁀𒀾𒅆𒆠𒄿𒀉𒋾	NEB
𒊹𒌓𒊹𒆚𒀭𒊹𒌋𒀭𒌓𒆠𒀀𒄩𒈨𒌍𒅆𒈨𒌍	STB
𒉻𒂍𒀀𒋛𒊑	OLB
𒉺𒋗𒄿𒌓𒀕𒆠	OLB
𒉿𒄿𒋙𒄿𒁖𒂵𒇻	NEB
𒆷𒅔𒉌𒅁𒁍𒍑	NEB
𒅟𒄀𒈾𒊮𒆳𒄭𒀭𒈨𒌍𒆳𒌵𒆠	STB
𒈤𒊒𒇷𒁍𒍑	NEB
𒈠𒆟𒂊𒋩𒌓𒈬𒉺𒋡𒊑𒀀𒈾	LTB
𒁹𒌋𒌋𒉡𒄿𒋡𒉿	LTB
𒇽𒈬𒁺𒌉𒃻𒌉𒃻𒀀	LTB
𒇻𒌋𒇽𒀸𒋩𒀀𒀀	NEA
𒅇𒅗𒌤𒀭𒅎𒊭𒊑𒄴𒍢	SUX
𒄑𒂍𒂟	SUX
𒀀𒈬𒊒𒆷𒋫𒃮𒁍	NEB
𒀴𒅟𒊹𒅅𒁉𒀸𒋩𒇽𒀀𒁀	NEA
𒍣𒃻𒊒𒌋𒅕𒋙	STB
𒄊𒈬𒆠𒉌𒉈𒍑	SUX
𒊹𒊓𒋛𒅀𒌉𒊹𒉌𒈠𒅕	NEB
𒇽𒃲𒄬𒍮𒈨𒌍𒆳𒌵𒆠𒀀𒀀	NEA
𒌉𒃻𒀸𒄷𒌓𒊮𒁉𒋙𒊩𒋙𒄩𒆷	LTB
𒁹𒄩𒍣𒅁𒋼𒋗𒌒	OLB
𒌉𒃻𒇽𒋢𒊬𒃻𒂵𒊹	LTB
𒈠𒆷𒁀𒋗𒌑𒀀𒈾𒀭𒈨𒌍𒅟	NEB
𒌓𒄰𒈨𒌍𒌅𒌌𒆪𒈾	MPB
𒀸𒄷𒌓𒊮𒁉𒋙𒈪𒋻𒈠𒆷𒄩𒆷𒋙𒃻𒀸𒂍𒋗𒈫	LTB
𒀉𒋰𒋗𒌑𒌉𒃻𒀀𒃻𒀀	LTB
𒈗𒈾𒁲𒂊𒀀𒄭𒉌𒋫	NEB
𒄿𒀭𒌓	SUX
𒊮𒆳𒄭𒀊𒀭𒈨𒌍𒆳𒌵𒆠𒁹𒊩𒅆𒂟	STB
𒃻𒂍𒁁𒉌𒋙𒌑𒈦𒅆𒊒𒈠	NEB
𒈗𒋾𒊹𒄞𒈨𒌍𒇻𒈨𒌍	NEA
𒀭𒈾𒊏𒄠𒀭𒂗𒍪	SUX
𒅖𒋼𒈪𒀀𒉿𒋼𒈨𒌍𒅟	MPB
𒍣𒂵𒊮𒂍𒀀𒋛𒀸	OLB
𒂍𒌈𒋙𒌋𒆠𒊒𒁀𒀀	LTB
𒁹𒂍𒀀𒈾𒁉𒉌𒉌	OLB
𒇯𒂔𒈾	SUX
𒈽𒆟𒈬	SUX
𒀭𒋢𒆳𒊒𒀭𒊩𒌆𒆤	SUX
𒅔𒈾𒀜𒉡	OLB
𒀀𒈾𒇽𒁕𒀀𒀀𒇻𒇽𒃲𒁕𒀀𒀀𒇻	NEB
𒌅𒃻𒍝𒀀𒍝	STB
𒄊𒉽𒁹𒆳𒋗𒅖𒊕𒅟𒀭	STB
𒅖𒌅𒍜𒅟𒇽𒈨𒌍𒌈𒇽𒅎𒆪𒋗𒌓	MPB
𒊹𒌉𒊏𒌋𒁇𒀸	OLB
𒊹𒀭𒇻𒅂𒅆𒇲𒀀𒀭	STB
𒅇𒁀𒁲𒄣𒉡𒈠𒊑𒌋𒌆𒇻𒉡	NEA
𒆷𒆠𒄿𒆬𒌓𒈨𒌍𒆷𒆠𒄿	MPB
𒀀𒈾𒁹𒉌𒅎𒈬𒌑𒀀𒊑𒅀𒈗𒆳𒈪𒄑𒊑𒄿𒋀𒅀𒄩𒋫𒉌𒅀	MPB
𒄿𒉈𒂗𒊹	NEA
𒄿𒈾𒌷𒀸𒀸𒄭𒀀𒈗𒂗𒅀𒀭𒅀𒀭𒌓𒅀	MPB
𒀸𒆳𒁇𒇻𒃻𒍝𒁉𒋾𒆷𒀀	NEA
𒊹𒀯𒀯𒁹𒊮𒊹𒌅	STB
𒀀𒈾𒀭𒈾𒈾𒀀	OLB
𒆍𒃲𒌷𒉽𒀸𒃼	STB
𒊹𒇽𒋃𒀀𒃻𒀀𒀕𒆠𒌗𒀳𒌓𒊹	LTB
𒊭𒀀𒁉𒅀𒌈	OLB
𒊭𒉌𒉌𒄿𒁷𒉆	OLB
𒋗𒋾𒀀	OLB
𒄿𒈾𒋾𒅋𒋾	NEB
𒌗𒌓𒁺𒌓𒊹	OLB
𒅇𒁮𒀀	NEB
𒁹𒁀𒌈	OLB
𒀭𒀭𒇽𒈦𒈦	SUX
𒂍𒃲𒄑	NEA
𒀀𒈾𒌷𒁍𒁀	OLB
𒃮𒁺𒆳𒈥𒌅𒆠	STB
𒊭𒅋𒅟𒀀𒀠𒋫𒋫𒊍𒍣𒈠𒀀𒈠𒋾𒋗𒂖𒋼𒈨	MPB
𒈠𒀀𒀸𒌋𒅗𒊹𒇻𒁺𒌑𒋗𒌒𒊒	NEA
𒀀𒀭𒌋𒀀𒆗𒀸𒆳𒄿𒄯𒊒𒁍	STB
𒇽𒄖𒊒𒈠𒀀𒀀𒃻𒀉𒋾𒋙	NEB
𒇺𒀠𒋙	NEB
𒀭𒊩𒌆𒁕𒃲𒍪	SUX
𒌉𒃻𒀸𒋗𒈫	LTB
𒁕𒈾𒀭𒈬𒀭𒈾𒂙𒉡𒋛𒁲	STB
𒊹𒊕𒀴𒀀𒈾𒂍𒁓𒊕	OLB
𒃻𒈗𒁁𒉌𒅀𒄠𒈠𒊒	NEB
𒀭𒁁𒁶𒄭𒄊𒀭𒌍	SUX
𒀭𒊩𒌆𒀀𒊒𒊒𒋗	SUX
𒊹𒇽𒀀𒋛𒀸𒇽𒀊𒉣𒈾	OLB
𒈨𒌍𒉺𒃻𒉌𒌈𒃻𒂍𒉺𒉌𒃻𒂍𒈬𒈨𒌍𒊹𒑛𒌑𒍑𒀭𒌑𒅎𒈥𒌅𒁕𒆠𒊒𒁀𒀀𒃻𒀀𒃻	LTB
𒊺𒉡𒊓𒄭	NEA
𒌑𒈠𒀀𒌋𒌆𒆷𒀀𒉌𒊭𒈗	NEA
𒊹𒋗𒅆𒊺𒄥	SUX
𒀀𒈾𒈬𒄭𒅟𒅇	MPB
𒀀𒈾𒌷𒂦𒌋𒌋𒁺	NEA
𒊭𒊹𒀭𒅀𒁕𒀪𒊭𒀸𒉆𒀜	NEA
𒀭𒈨𒌍𒃲𒈨𒌍𒀀𒅆𒁍𒀭𒂊𒅇𒆠𒁴𒌌𒌅𒌌𒆷𒉡𒌝𒈠	NEB
𒊹𒊭𒊹𒊹𒊭𒌓𒋛𒊭𒂵	NEA
𒆠𒉆𒉈𒊒𒂠	SUX
𒊹𒈠𒈾𒉚𒄩𒆷𒀸𒂍𒈬𒈨𒌍𒌀𒈨𒌍𒀀𒃻𒌋	LTB
𒀭𒂗𒍪𒄿	OLB
𒇽𒈬𒌨𒋡𒀭𒉡𒆠𒊒𒁀𒀀𒈬𒈨𒌍	LTB
𒂍𒊮𒄾𒀀𒉌	SUX
𒅇𒊹𒊹𒈨𒈨𒌍𒂟𒈨𒌍𒄊	MPB
𒅇𒄿𒉺𒀠𒇷𒀉𒄿𒋼	MPB
𒃮𒁉𒃻𒌗𒊻𒋢	LTB
𒍑𒀭𒋫𒅎𒈥𒌅	LTB
𒀸𒊮𒁉𒇽𒀀𒅆𒁍𒋼𒀀𒈾𒌉𒋙	NEA
𒀭𒅅𒀭𒈾𒅅𒆷𒁮𒁉𒊩	SUX
𒊒𒄿𒈾𒋗𒊹𒆳𒀭𒀸𒋩𒆠	NEB
𒀸𒅟𒀀𒊒𒊭𒈗𒂗𒅀𒆷𒂊𒆷𒀀𒉌𒌋	NEA
𒆪𒌑𒊑𒌅𒆑𒌓𒉈𒁕𒀊𒋾𒆷	STB
𒇽𒋀𒉠𒌑𒀀𒈾𒌓𒈬𒍝𒀀𒌓𒊹𒂆𒆬𒌓𒉽𒁀𒉡𒌑𒄿𒉆𒁷	LTB
𒄿𒈾𒋡𒀜𒁹𒋫𒄴𒈠𒅀	MPB
𒌓𒊹𒌓𒊹𒌓𒊹	LTB
𒇽𒉺𒈥𒌅𒈨𒌍𒄖𒌅𒌈	OLB
𒀀𒃻𒌉𒃻𒀀	LTB
𒁀𒆷𒍮𒋗𒆠𒉡	STB
𒉺𒉌𒀀𒋼𒊭𒊺𒋰𒆪	NEA
𒋾𒃻𒈗𒁷𒌁𒆠	NEB
𒉿𒁍𒋗𒁺𒌝𒋡	MPB
𒃻𒁀𒈗	OLB
𒇽𒄖𒋾𒌝𒆠	OLB
𒈗𒆠𒂗𒄀𒆠𒌵	SUX
𒃻𒌷𒈠𒋥𒀸𒋗𒊹𒈗𒂗𒅀	NEB
𒈧𒀲𒈨𒌍𒆳𒌵𒆠𒁇𒂵𒌋𒌋	STB
𒀭𒈨𒌍𒍑𒈨𒌍𒋗𒁁𒈨𒌍𒅇𒀭𒈨𒌍𒋆𒇷	LTB
𒁲𒉺𒉌𒋙𒉡	NEB
𒇽𒄬𒌉𒇽𒄬𒈠𒃻𒀀𒈾	NEB
𒄑𒊒𒁀𒈬𒈨𒌍𒌉𒈨𒌍𒃻𒀀	LTB
𒅆𒁾𒆗𒂵𒉌	SUX
𒁹𒋛𒇻𒆪𒈗𒌓𒊹𒄑𒊒𒁀𒇽𒄈𒇲𒌑𒌓𒈬𒈨𒌍	LTB
𒄑𒄯𒈨𒌍𒀭𒂊𒌋𒆠𒁴𒅖𒆪𒉡	STB
𒀀𒈾𒆪𒊒𒈠𒀜𒂍	OLB
𒁁𒉌𒅀𒀖𒁲𒉡	NEB
𒌒𒋼𒀪𒌑	NEB
𒀀𒈾𒌷𒅀𒀀𒁍𒆠𒋗𒌓	MPB
𒅋𒋫𒌓𒈗𒆳𒉏𒈠𒆠𒀉𒋾𒋙	NEB
𒌜𒆸𒅆𒆳𒁳𒁁𒈠	STB
𒆠𒄿𒄩𒀭𒉌𒂊𒌨𒈠𒊒𒆪𒉡	STB
𒀭𒄑𒊭𒄠𒌑𒋗	SUX
𒁕𒀪𒈾𒂊𒇷𒀀𒁺	NEA
𒁹𒀀𒉌𒌈𒊮𒊭𒀠𒆷𒀜𒈾𒀜𒁀𒄰	OLB
𒀭𒌉𒊩𒀹𒁯𒊭𒍝𒇻𒄷𒌝	OLB
𒀯𒂊𒌅𒉘𒈪	STB
𒇽𒃻𒌋𒅗𒄭𒂍𒌝𒈠𒊹𒄰	NEB
𒆷𒌑𒈦𒊬𒀭𒈾𒀀𒅆𒀀𒈨𒌍𒂊𒉌	NEB
𒀀𒈾𒀭𒀫𒌓𒀜𒆗	OLB
𒌉𒃻𒀸𒋗𒈫𒌉𒃻𒀀𒈠𒆟𒂊𒋩	LTB
𒄊𒀭𒅎𒋫𒅀𒅈	OLB
𒆷𒀀𒍮𒊒𒆷𒀀𒈬𒀀𒋫	NEA
𒇽𒃲𒅟𒈲𒁁𒉌𒋙	NEB
𒋗𒅎𒈠𒁀	SUX
𒊩𒌆𒋙𒄿𒃻𒀪𒀠	NEB
𒄑𒁄𒄑𒆟𒁕	SUX
𒋳𒈠𒀴𒊭𒈗𒀜𒁕𒆠𒄿𒆠𒄿𒀉𒋾	MPB
𒆷𒂍𒀲𒆳𒊏𒌋𒆷𒂍𒄑𒇀𒇽𒌓𒁴𒈬𒈨𒌍𒀀𒈾𒌓𒈬𒍝𒀀𒌈	LTB
𒇺𒀠𒋙𒉡𒌅𒁳𒁉𒄿𒁀𒀾𒋙𒃻𒈗	NEB
𒁾𒈨𒌍	STB
𒁮𒀀𒃻𒀀𒀀𒈾𒌓𒈬𒍝𒀀𒌓	LTB
𒁹𒉌𒉌𒊏𒁉𒀊𒉣𒈾𒆠	OLB
𒆷𒈠𒌈	MPB
𒋗𒉡𒌝𒈠𒆷𒀸𒄩𒁺𒋼𒂊𒋗𒌋𒌑𒁀𒀜𒋾𒄣	NEA
𒀠𒆷𒄰𒈠𒇽𒌓𒃻𒈬𒋾	NEA
𒌉𒊩𒃻𒇽𒋗𒄩𒃻𒂗𒈾𒅔𒂵𒀀𒌉𒃻𒇽𒉄	LTB
𒇽𒉄𒋗𒌋𒋫𒋡𒀭	NEA
𒅆𒌨𒃻𒆳𒈥𒌅𒆠	STB
𒀀𒌉𒃻𒀀𒌉𒃻𒀀	LTB
𒌋𒄘𒆬𒄀	SUX
𒈾𒁉𒄿𒉌𒋗	OLB
𒆠𒋾𒅀𒀀𒈾𒉺𒉌𒈗𒊑	MPB
𒊹𒈾𒋛𒁇𒇽𒃲𒌷𒈨𒌍	NEA
𒊹𒌉𒊩𒌉	OLB
𒀀𒈾𒂍𒄷𒄭𒀀	OLB
𒌈𒋫𒀭𒊬𒊑	SUX
𒅇𒊹𒀉𒌌𒄿𒁺𒌑	NEB
𒀭𒀭𒋗	SUX
𒋞𒄭𒀀𒋧𒈬𒉈	SUX
𒃻𒉌𒐕	SUX
𒀉𒌁𒀀𒈾𒈗𒁁𒉌𒅀𒇻𒌑𒈪𒁲𒊹𒃻𒀭𒀝𒋙𒌋	NEB
𒋛𒄠𒋛	SUX
𒃮𒁕𒈥𒌅𒆠𒄴𒆷𒈬𒌑𒅥	STB
𒄑𒇀𒈨𒌍𒅀	MPB
𒌷𒄩𒍝𒋫𒀀	NEA
𒀭𒌉𒂍𒀀𒈾	NEB
𒌑𒍝𒁉𒌅𒌋𒉌	NEA
𒈗𒆳𒆳𒀜𒅟𒊌𒊑𒇷𒁀𒀭𒈾𒅆	NEB
𒈗𒊑𒂗𒅀𒀀𒉡𒈠	MPB
𒈬𒀭𒈾𒀭𒉌𒌓	NEA
𒅇𒈗𒂗𒅀𒅇𒇽𒈨𒌍𒃲𒁍𒋼𒈨𒌍	MPB
𒀜𒋫𒆰𒈨𒌍𒁺	NEA
𒊭𒍣𒈾𒌈	OLB
𒄑𒍎𒁉𒉌𒁹𒅆𒀭𒊹𒋻𒁉	STB
𒀉𒊑𒅟𒅅𒁲𒁉𒀀𒈠𒀀	NEA
𒄑𒄖𒍝𒁺𒁀𒍪𒇽𒉡𒉽𒂊	SUX
𒅀𒀀𒅆𒀀𒈾𒌷𒅀𒊺𒅎	MPB
𒊭𒉌𒌓𒁕𒈪𒅅𒄿𒈾𒉺𒉌	MPB
𒈬𒈨𒌍𒌀𒈨𒌍𒅇	LTB
𒇻𒈬𒌈	MPB
𒁹𒅟𒆠𒉆𒈦𒌈𒁕	STB
𒁁𒂖𒋗𒉡𒃻𒋗𒀭𒂗𒍪𒊺𒈪	OLB
𒊹𒊹𒉣𒇬𒆸𒈠	STB
𒂍𒈠𒀭𒉌𒉌	SUX
𒅆𒀭𒂗𒆤	SUX
𒈫𒄞𒁆𒀭𒈠𒉣𒃲𒆤	SUX
𒅟𒀀𒀀𒈠𒉡𒈪𒄿𒉡𒊭𒉈𒂗𒋙𒉌𒅆𒈪𒀀𒁺𒁉𒀉𒀀𒊑𒋡𒀭𒉌	NEA
𒋡𒇻𒌑𒄑𒋫𒌁𒊏𒉡𒃻𒁹	LTB
𒈠𒈾𒆬𒌓𒊹𒈠𒈾𒆬𒄀	NEA
𒇻𒌑𒄿𒁲𒈗𒂗𒅀𒄿𒉡𒈠	MPB
𒄑𒂼𒄑𒈠	SUX
𒀭𒌓𒌓𒁺𒀭𒌓	SUX
𒍑𒅆𒅕𒀀𒈾𒀭𒉈𒈨𒌍𒂊𒊭𒋼	MPB
𒊭𒅖𒋰𒁇𒈗𒊑𒂗𒅀	MPB
𒈫𒄊𒊺𒂊𒉿	STB
𒂊𒄯𒌑𒉌	NEA
𒉒𒁶𒆠𒂼𒆷𒉈𒁺	SUX
𒁕𒈨𒌍𒉺𒊹𒉣𒇬𒃻𒂍𒈬𒈨𒌍𒌋𒁕𒂍𒌋𒉣𒇬𒃻𒀀𒃻	LTB
𒉺𒉌𒈗𒉺𒉡𒋫𒌑𒉺𒀪𒄿	MPB
𒀀𒈾𒇽𒊹𒂊𒂗𒐊	NEA
𒋗𒀭𒂄𒄀𒋗𒄿	SUX
𒌓𒊹𒆚𒅔𒋻𒈠𒄫	STB
𒈗𒆳𒋢𒁄𒋢	STB
𒋙𒌑𒆍𒀭𒊏𒆠	NEA
𒋗𒁍𒈜𒁍	NEA
𒌉𒊩𒃻𒊹𒆠𒊒𒁀𒀀𒋙𒆠𒁴𒆍𒃲𒀭𒌓𒃻𒆠𒆗𒀕𒆠	LTB
𒁉𒄑𒀀𒂊	NEA
𒊹𒇽𒌓𒀕𒆠	OLB
𒀸𒉺𒉌𒀭𒈨𒌍𒄿𒋼𒀀𒊏𒁍𒋙𒉡𒋾	NEB
𒀀𒈾𒊹𒋛	NEA
𒊭𒊭𒇻𒀸𒉺𒊩𒍑𒁇	OLB
𒀸𒌓𒊹𒄑𒊒𒁀𒋙𒇽𒋋𒌑𒌓𒅆𒊹𒀭𒌈𒀭𒂗𒆤	LTB
𒁹𒍝𒉌𒅅𒂵𒁍𒊭	OLB
𒊕𒋢𒉡𒄿𒈾𒅆	NEA
𒊹𒊹𒀸𒌗𒆥𒌓𒊹𒆚𒅆	STB
𒀭𒊭𒀀𒊏𒈛𒈤𒀭𒂗𒆠𒂵𒆤	SUX
𒅖𒋼𒌋𒌋𒃻𒀭	STB
𒊮𒅗𒆟𒁉𒋫	SUX
𒀀𒈾𒂍𒀀𒋛𒀸	OLB
𒌅𒍝𒋫𒀪𒌒	STB
𒈗𒂗𒅀𒉺𒉡𒌓𒅇𒄭𒂵𒋫	MPB
𒍜𒈨𒌍𒃻𒌉𒈨𒌍𒆪𒉡𒇻𒊺𒊑𒁍	STB
𒁹𒇷𒋢	LTB
𒀭𒁲𒋻	SUX
𒀸𒌋𒅗𒅗𒅗𒀭𒉌𒄿	NEA
𒇷𒈬𒁹𒀭	STB
𒄿𒋛𒋙𒀀𒁕𒁍𒁍𒌋𒉌	NEA
𒊹𒀸𒌗𒉈𒀭𒅎𒅗𒋙𒊒𒌓𒋙𒌒𒀭𒋩𒉣	STB
𒋢𒀀𒈾𒆪	NEB
𒄊𒀭𒂗𒍪𒉌𒄿𒄖𒍝𒇲	OLB
𒀭𒅆𒁾𒋾𒋗	SUX
𒈗𒁁𒅀𒅇	MPB
𒁹𒈾𒉿𒅈𒊭𒇻𒄯	OLB
𒌝𒈠𒀠𒅟𒉡𒊹𒀭𒌓𒅁𒉌	NEB
𒁕𒈨𒌍𒉺𒃻𒉌𒌓𒃻𒂍𒈬𒈨𒌍𒊹𒈦𒌑𒍑𒆠𒌑𒅎𒆳𒊏𒁕𒂍𒌉𒊩	LTB
𒈰𒉌𒁄𒁄	SUX
𒅖𒁓𒀭𒉌𒈠𒀀𒊹𒀝𒅟𒁕𒀀𒀀	NEA
𒌉𒊩𒃻𒀀𒃻𒀀𒁮𒊹	LTB
𒉌𒌓𒈾𒇻𒀀	SUX
𒀀𒈾𒆪𒇽	MPB
𒄿𒉆𒁺𒌑	NEB
𒀭𒊩𒌆𒆠𒋗	SUX
𒀭𒂼𒅇𒌅𒁕	SUX
𒀭𒅎𒄿𒊏𒄭𒄑	STB
𒀭𒈨𒌍𒃻𒂗𒆤𒆠𒅇𒁷𒌁𒆠𒌓𒈨𒌍𒃻𒈗𒁁𒉌𒅀𒇻𒌨𒊑𒆪	NEB
𒁇𒁳𒁍𒆪𒋛𒁍	STB
𒁹𒌋𒌋𒉡𒄿𒋡𒁍	LTB
𒀭𒅀𒀭𒌓𒅀𒉌𒊭𒀠𒋗𒉡𒁍𒄩𒀜	MPB
𒌷𒀀𒃼𒀭𒉺	NEA
𒁹𒄩𒉈𒆠𒉡	OLB
𒀸𒁍𒁍𒋾𒀉𒁺𒊌	NEB
𒅇𒊩𒈠𒃻𒆷𒀀𒄩𒈨𒌍	NEB
𒁹𒉄𒅀	LTB
𒈪𒄿𒉡𒉈𒂗𒋗𒀸𒆳𒌑𒋗𒌑	NEA
𒊭𒁉𒅕𒀀𒇉𒀀𒋩𒀸	OLB
𒀠𒅟𒋾𒀀𒈾𒌷𒍮𒈬𒊏	MPB
𒉌𒅇𒇽𒈛𒀸𒌋𒅗𒄭	NEA
𒌉𒂗𒀭𒈾𒁺	OLB
𒀭𒌴𒋗	SUX
𒀀𒁲𒈠𒄠𒈠𒋫𒈥	STB
𒄿𒄩𒊍𒊓𒋢𒈧𒀲𒆳𒌵𒆠𒌓𒂵𒌋𒌋	STB
𒀸𒄘𒌦𒆬𒌓𒊹	SUX
𒊩𒈾𒁷𒈾𒀜𒆠𒊒𒁀𒀀𒈬𒈨𒌍	LTB
𒉆𒄩𒅈𒋾𒁹𒉺𒄿𒆷	OLB
𒑏𒑏𒑏𒑏𒋡𒋡𒋡𒋡𒋡𒋡𒋡𒋡𒍥𒁕	OLB
𒀀𒈾𒆳𒄿𒈾𒀾𒃻𒀀	STB
𒃻𒋗𒈬𒄩𒁺𒌝𒈜𒃲	OLB
𒋾𒁉𒉌	SUX
𒁹𒆪𒉌𒆜𒁺	STB
𒀸𒉣𒇬𒋙𒊩𒅆𒈬𒍮𒌑𒋫𒄩𒆷𒃻𒊹𒈬𒈨𒌍𒀸𒂍𒀀𒋢𒌒𒁍	LTB
𒈬𒌦𒃮	SUX
𒀀𒈾𒌓𒈬𒍝𒀀𒌓𒀉𒋫𒁷	LTB
𒀭𒊩𒌆𒊹𒉣𒈾𒋗	SUX
𒀭𒈗𒄑𒋤𒊏𒈬𒄴𒊏	SUX
𒌓𒁕𒈬𒂠𒉚𒉚	SUX
𒅔𒈾𒀜𒈾	OLB
𒅕𒊒𒁀	NEB
𒉈𒅟𒁺	STB
𒅆𒈪𒀀𒈾𒅀𒅆𒅇𒋳𒈠𒅀𒉡	MPB
𒆍𒀭𒆠	SUX
𒀀𒈾𒀭𒀫𒌓𒇺𒆲	STB
𒊭𒄷𒍝𒈝𒉺𒊩𒆳𒌒𒇴	OLB
𒀭𒍣𒁀𒀭𒊺𒀭𒁲𒋻	SUX
𒁀𒊑𒂵𒁀𒊑𒂵𒍥𒁕	OLB
𒀫𒄄𒀀𒉌𒅔𒃻	SUX
𒅆𒊹𒌋𒌋𒉡𒅟𒋛𒀪𒇽𒌣𒆬𒄀	NEA
𒀭𒈪𒁉𒄿𒋼𒋾𒅅𒌷𒁄𒌷𒃻𒈗	STB
𒊹𒀀𒈬𒁕𒉌	NEA
𒆜𒁍𒃵𒄯𒋫𒁷𒇽𒋗𒀀𒌅	NEA
𒁀𒊑𒂵𒁀𒊑𒂵𒁀𒊑𒂵𒁀𒊑𒂵𒑏𒑏𒑏	STB
𒌨𒀸𒂍𒃲𒈗𒄑𒍝𒅖𒀸𒅆𒈬𒀭𒈾𒀭	STB
𒁹𒀭𒈾𒈾𒀀𒈬𒇽𒁃𒀀𒈾𒌓𒈬𒍝𒀀𒌓𒀉𒆗𒉡𒀪	LTB
𒂗𒅀𒋳𒈠𒄿𒈾𒈠	MPB
𒊭𒄿𒈾𒀀𒃼𒀀𒊮𒉋	OLB
𒈧𒀲𒆳𒌵𒆠	STB
𒀀𒈾𒌋𒅗𒉈𒂊𒈬𒃻𒊹𒂗𒋙𒉡𒂍𒇽𒁕𒆪𒊏𒀀𒀀	NEB
𒅎𒁾𒄩𒆷𒃻𒌋𒌉𒈨𒌍𒃻𒌋𒌉𒈨𒌍𒃻	LTB
𒀸𒁷𒌁𒆠	NEB
𒂍𒉌𒆠𒁉𒈬𒈾𒄄	SUX
𒀀𒈾𒌷𒁍𒁀𒅔𒈾𒀜𒉡	OLB
𒁹𒍝𒁉𒌈𒋢𒌝𒆠	OLB
𒊹𒉿𒑏𒑏𒑏𒑏𒄑𒊒𒁀𒈬𒈨𒌍𒇽𒈬𒌑𒌓𒌋𒇽𒄯𒌑𒌓𒃻𒀸𒅆𒊹𒀭𒌈	LTB
𒀭𒋫𒅎𒋛𒁲𒁕𒂍𒊩𒊩𒆳𒀭𒂼𒃣𒌉𒊩𒊹𒁮𒀀𒃻	LTB
𒀸𒄷𒌓𒊮𒁉𒋙𒉡𒈪𒋻𒄩𒆷𒋙𒉡𒃮𒁉𒃻𒀸𒂍𒅎𒍇𒇻𒂍𒅎	LTB
𒃻𒋗𒀀𒉋𒉌𒉌𒋗𒉺𒈥𒌅𒌒𒇴	OLB
𒀀𒁲𒊹𒀀𒈾𒊹𒀀𒈾𒌓𒈬𒍝𒀀𒌓𒀸𒀭𒁷𒀪𒁍𒌓𒀀𒄩𒈩	LTB
𒃻𒀸𒌓𒊹𒃻𒌗𒊻𒋢𒀀𒈾𒊹𒀜𒀜𒋙	LTB
𒉈𒁕𒀊𒋾𒆷𒋡𒌁𒋾𒌅𒊬𒊏𒀊𒀀𒁲	STB
𒊭𒂡𒂡𒌓𒅗𒁇𒄿𒈾𒌓	MPB
𒂍𒅆𒂍𒁲𒌦𒈠	SUX
𒁁𒀠𒅖𒋫𒃶𒌋𒋛𒌋𒌋𒉡𒌌𒋼𒋾𒅅𒀀𒁲𒆷𒀪	LTB
𒄿𒌅𒊏𒄠	OLB
𒅆𒊹𒀭𒂗	NEA
𒀀𒈾𒅆𒊹𒋙𒉡	NEA
𒀭𒊮𒀸𒁺𒃻𒈬𒋗	SUX
𒍣𒉌𒀭	OLB
𒇽𒆍𒀭𒊏𒆠	OLB
𒁳𒁉𒃻𒇽𒁷𒌁𒆠𒈨𒌍𒀸𒉺𒀭𒈗𒀉𒁍𒁍	NEB
𒆠𒆠𒆗𒁉𒂠	SUX
𒊹𒌑𒍑𒀭𒌑𒅎𒋛𒁲𒁕𒂍𒌉𒊩𒃻	LTB
𒀴𒈨𒌍𒅟𒇽𒂗𒆤𒆠𒈨𒌍	NEB
𒁹𒁁𒂖𒋾𒂊𒋾𒅕𒋾𒌉𒃮𒌉𒉌	OLB
𒌑𒇽𒀀𒈨𒊑𒃻𒈗𒆳𒉏𒆠	NEB
𒌉𒃻𒀀	LTB
𒇻𒌋𒀾𒈨	NEB
𒊹𒊩𒋗𒄀𒀸𒋗𒊑𒌈	OLB
𒉡𒌒𒈭𒄭𒀀𒈾𒁁𒄭	NEB
𒈨𒌍𒃻𒊏𒌋𒌋𒉌𒋙𒀸𒋗𒈫𒌉𒈨𒌍𒃻	LTB
𒋙𒁹𒈗𒌨𒁍𒌑	NEB
𒉡𒌓𒈨𒅖𒀸𒌷𒂄𒉌𒀭𒃻𒈦	NEA
𒀀𒁲𒈠𒋾𒄿𒍣𒍝𒋼𒀉𒋾𒋗𒅇𒉿𒁲𒈾𒈗𒂟𒈨𒌍𒆷𒀀𒈪	MPB
𒀭𒈠𒌨	SUX
𒃻𒂍𒂗𒋙𒄿𒊏𒈬𒀀𒈾𒆪	NEB
𒊺𒊑𒁉𒀀𒆠𒊭𒈗𒁁𒉌	NEA
𒀀𒁲𒂊𒅖𒃻𒁲𒅕	NEB
𒊹𒀸𒌓𒆷𒅕𒁉𒀭𒅎𒄑𒋛	STB
𒊹𒊩𒌉𒊹𒌉	OLB
𒉌𒋛𒅔𒆠	OLB
𒀸𒄯𒊕𒌦𒈠𒆠𒀸𒄑𒈠𒅆𒄷	LTB
𒉌𒌓𒉭𒋛𒀀	SUX
𒅇𒌨𒁇𒊏𒈨𒌍	STB
𒅇𒅔𒉌𒊑𒅕𒀀𒈾𒆪𒅖𒌅𒌷𒅕𒃰𒆠	MPB
𒊹𒊕𒊩𒆳𒀴𒊩𒍑𒁇	OLB
𒂊𒌀𒅗𒀹𒁯𒉆𒄩𒅈𒋾	OLB
𒂍𒋻𒁍𒁍	SUX
𒀭𒋢𒈬𒀭	SUX
𒌋𒅗𒈝𒈠𒋙𒉡𒈠𒆷	NEB
𒌉𒈨𒌍𒋙𒉡𒀊	NEB
𒅇𒈪𒄿𒈾𒄠𒈨𒂊𒊭𒀉𒁷𒉡𒉏	MPB
𒊹𒊕𒀴𒈨𒌍𒀀𒋛𒊒𒌑	OLB
𒀭𒂗𒆤𒀭𒊩𒌆𒆤𒀭𒈦𒅇𒀭𒉺𒌆	NEB
𒋫𒌋𒅗𒀀𒇉𒋫	NEA
𒆠𒁴𒆳𒊒𒁲	STB
𒀸𒌋𒅗𒌦𒈨𒌍𒀀𒉡𒌓	NEA
𒈬𒅆𒌨𒀀	SUX
𒀭𒍣𒆗𒆷𒊺𒈫	SUX
𒉺𒌋𒌋𒄷	STB
𒀀𒈾𒄑𒇀𒈨𒌍𒅟𒀀𒈾𒀲𒆳𒊏𒈨𒌍𒅟𒀀𒈾𒂟𒃲𒈨𒌍𒅟	MPB
𒀭𒆬𒋤	SUX
𒀸𒉌𒄑𒅇𒍥𒁕𒅔𒀮𒉺𒄴	STB
𒊭𒀸𒅆𒂍𒈗	NEA
𒊹𒆷𒁀𒅆𒄿𒃮𒁉𒌝𒈠𒀀𒆳	NEB
𒊹𒀸𒌗𒀊𒌓𒊹𒆚	STB
𒂊𒊒𒁍𒌋𒉌𒀸𒌋𒅗𒊹𒊏𒈠𒋾𒄿	NEA
𒀀𒈾𒄊𒈨𒌍𒂗𒅀𒊹𒅇𒊹𒄠𒆪𒌓	MPB
𒊹𒊕𒀴𒊹𒊕𒊩𒆳	OLB
𒑏𒑏𒑏𒍥𒁕	OLB
𒊻𒂟𒁉𒌅𒀀𒈾	NEB
𒊹𒄭𒅔𒉡𒈬𒇽𒀕𒆠𒀀𒀀𒄿𒈾𒊮𒁉𒊩𒈠𒃻𒆷𒉌	NEB
𒋾𒋼𒁍𒋗𒈪𒀀𒈾𒌉𒈨𒌍𒁹𒀴𒀸𒊏𒋾	MPB
𒀭𒂗𒆤𒈠𒇷𒆪	STB
𒈨𒌍𒉺𒅆𒌈𒃻𒂍𒈬𒈨𒌍𒊹𒌑𒊕𒆠𒆠𒋫𒅎𒍇𒇻𒁕𒋻𒋗𒈫𒉡𒈬𒋳𒋡𒌦𒈨𒌍𒈨𒌍𒉺𒃻𒈜𒌈𒃻	LTB
𒆰𒆪𒉡𒆰𒈨𒌍𒃻𒋀𒈨𒌍𒆪𒉡𒌉𒈨𒌍𒆪𒉡𒌉𒊩𒈨𒌍𒆪𒉡	STB
𒇽𒊕𒊭𒉺𒅁𒊒𒉌	NEA
𒅇𒁉𒀉	NEA
𒌋𒌋𒌋𒌋𒌋𒌋𒌋𒌋𒌋𒃷𒀀𒊮𒊹	SUX
𒅔𒈾𒊏𒋢	SUX
𒈠𒁕𒂊𒈬𒌓𒁀𒈝	SUX
𒄿𒈾𒋛𒅇𒈗	NEB
𒇽𒄖𒋾𒌝𒆠𒈨𒌍	OLB
𒀀𒈾𒄸𒁍𒈨𒌍	OLB
𒊹𒊕𒀴𒈨𒌍𒊭𒌉	OLB
𒅆𒅁𒊑𒀭𒉡𒌑	MPB
𒋀𒈨𒌍𒋙𒉽𒊹𒄘𒌦𒆬𒌓	NEA
𒀸𒌓𒈬𒈬𒈨𒌍𒄑𒊒𒁀𒇽𒆭𒂍𒌑𒌓𒅆𒀭𒂗𒆤𒀭𒂍𒀀𒊹𒀭𒌓	LTB
𒀀𒈾𒁹𒈗𒂗𒅀𒀭𒌓𒅀	MPB
𒋚𒈨𒌍𒀉𒋫𒈾𒁕𒊒𒊭𒅖𒊺𒄖𒌑𒈾𒀜𒊑𒊺𒄖𒌑	STB
𒅇𒁁𒆷𒉡𒌝𒊮𒌓𒍣𒂵	OLB
𒈬𒈨𒌍𒊩𒋗𒉈𒌈𒈾𒁷𒈾𒀜𒂍𒆪𒊒𒌒𒁍𒈬𒈨𒌍	LTB
𒉺𒉌𒈗𒂗𒅀𒉺𒉡𒌓𒇻𒌑𒀀𒄯	MPB
𒌑𒋻𒊒𒋙𒉡𒋾𒈠	NEB
𒌷𒂍𒁍𒈾𒆠𒆠𒈠𒍢𒈥𒁲𒂊𒋾	NEA
𒀭𒆏𒋫	SUX
𒊹𒀭𒅓𒁉𒆳𒉏𒈠𒆠𒆤	SUX
𒌗𒇯𒆬𒌓𒊹	OLB
𒊩𒈨𒌍𒍑𒈨𒌍𒅇𒌅	STB
𒅎𒄥𒀭𒂗𒍪	OLB
𒁹𒀀𒉌𒀀𒄭	OLB
𒃻𒋗𒈛𒄩𒄊𒈨𒌍𒆬𒌓	MPB
𒌅𒄩𒄠𒈠𒄠	STB
𒁹𒊑𒅁𒀭𒅎𒄿𒈾	MPB
𒇽𒄩𒀜𒉡𒊭𒁹𒈠𒀭𒅀𒋡𒁺𒌉𒈨𒌍𒋗	MPB
𒆠𒇷𒀭	OLB
𒈠𒀀𒌑𒁕	NEA
𒌓𒋙𒋙𒊒𒌓𒅕𒉿	STB
𒊭𒉌𒌓𒍝𒆳𒆳𒉌𒌓𒍝𒆳𒆳𒉌𒌓𒆳	MPB
𒌑𒊒𒃻𒌍𒌋𒌋𒌈𒈾	STB
𒊹𒊩𒀀𒄩𒌈	OLB
𒊹𒌉𒊏𒀀𒁉𒆠𒈠𒀭𒀫𒌓	OLB
𒀀𒉡𒈠	MPB
𒆠𒈫𒀸𒌗𒁈𒌓𒊹𒋫𒀭𒀝𒀸𒅟𒊑𒊹𒁺𒈠	STB
𒊭𒈾𒊏𒄠𒊭𒊒𒌫	OLB
𒌓𒀕𒆠𒈠	SUX
𒊹𒌉𒃻𒁹𒋺𒆗𒉡𒀀𒁹𒂍𒆳𒍝𒄫	LTB
𒀴𒅟𒊹𒀭𒉺𒂗𒁺𒅔	NEA
𒅇𒀀𒆳𒈗𒈾𒍝𒊑𒋗𒄷𒍪𒇸𒇷𒆚𒈠	NEB
𒂊𒈠𒀀𒃻𒋢𒅟𒋡𒋾𒍝𒁁	STB
𒆠𒈠𒀭𒌓𒂟𒅕𒈧𒈪𒋙𒅆𒂟𒈨𒌍𒋾𒆷𒌓𒋻	STB
𒀀𒈾𒆪𒀠𒆷𒀝𒈨𒋡𒁺	MPB
𒀸𒇷𒂊𒊺𒇻𒆷𒄿𒁕𒀊𒁍𒀀𒍮𒁕𒋾𒆪𒉡𒇷𒂊𒋗	STB
𒂍𒀜𒁕𒅎𒊕𒂷	SUX
𒃻𒁉𒈩𒋙𒉡𒀸𒌗𒈬𒊹𒁹𒋛𒇻𒆪𒈗𒀸𒄷𒌓𒊮𒁉𒋙𒉡𒆠𒀀𒄩𒀀𒈩	LTB
𒆠𒄿𒀾𒁍𒊏𒋗𒌑	NEB
𒆠𒈫𒆠𒈫𒆠𒄿𒃻𒃻𒈨𒌍𒌋𒃾𒈨𒌍𒀸𒊮𒁉𒅕𒊑𒆪𒉡𒅕𒊐𒌋𒉌	STB
𒅗𒅗𒆷𒋙𒌋𒌋𒉡𒃻𒀸𒌨𒆧	NEA
𒀀𒈾𒌋𒅗𒀀𒉌𒃻𒈗𒁁𒉌	NEB
𒁹𒈠𒉌𒂊𒇽𒌉𒆥𒋗𒊭𒋀𒅀	MPB
𒊹𒊨𒆕𒄷𒁍𒀪𒌋𒊏𒆕𒈠	STB
𒈠𒀀𒂍𒅟	NEB
𒌋𒌈𒋙	LTB
𒂕𒊏𒀭𒊩𒌆𒅁𒅆𒁺𒁀𒌀𒋫	SUX
𒆠𒌑𒅎𒆳𒊏𒁕𒂍𒀀𒃻𒃻𒋫𒇽𒉺𒇻𒈨𒌍𒃻𒂍𒀭𒈨𒌍𒃻𒀕𒆠	LTB
𒀀𒈾𒇽𒈨𒌍𒊓𒄤𒈨𒌍	MPB
𒋗𒌑𒀸𒋫𒄷𒈨	NEA
𒃻𒋗𒌓𒄷𒌝	OLB
𒀭𒍝𒅈𒅇	MPB
𒈬𒃻𒊹𒀀𒂵𒀀𒀸𒋢𒊬𒈨𒌍𒃻𒂍𒀭𒈨𒌍𒌋	LTB
𒂊𒉡𒈠𒍑𒅆𒆪𒌋𒊑𒃻𒉌𒌓	STB
𒊹𒊕𒀴𒊭𒀴𒊏𒈾𒍢𒅕	OLB
𒌉𒃻𒀀𒃻	LTB
𒅁𒋫𒋻𒊹𒂗𒀸𒊮𒁉𒋙𒉡𒆠𒄿	NEB
𒁕𒊍𒋢	NEB
𒀀𒈾𒂟𒄿𒈾𒀭𒈾	MPB
𒊺𒄑𒉌𒉚𒉚𒉈	SUX
𒃻𒁁𒉌𒅖𒁍𒊏	NEB
𒁹𒀸𒋩𒆕𒀀𒈗𒃲𒈗𒆗𒉡𒈗𒋙𒈗𒆳𒀸𒋩𒆠	STB
𒊹𒊩𒊕𒀸𒊹𒊮𒀜𒊹𒊩𒋗𒄀	OLB
𒁹𒀀𒄩𒄠𒅈𒅆𒇽𒀊𒉣𒈾	OLB
𒊭𒌉𒅕𒍢𒁴𒄊𒀴𒂦𒁾𒉄𒆠	OLB
𒀀𒈾𒊹𒂆𒈦𒂆𒆬𒌓𒄑𒋫𒌁𒊏𒉡𒃻𒁹𒀭𒋾𒀪𒄿𒆪𒋢	LTB
𒁀𒊑𒂵𒁀𒊑𒂵𒑏𒑏𒑏𒍥𒁕	OLB
𒆷𒁕𒀊𒀀𒃶𒉌𒀸𒌋𒅗𒊹𒈨𒀲𒆳𒈨	NEA
𒆬𒌓𒃲𒀀𒈾𒌉𒃻𒀀𒀸𒀭𒁷	LTB
𒀭𒊩𒌆𒌷𒌌𒆷𒈫	SUX
𒇸𒌨𒆪𒉡	NEB
𒋗𒂵𒇴𒆠𒄭𒄊𒁀𒅎𒈪𒉌𒃻	SUX
𒊹𒊹𒉣𒇬𒆸𒈠𒀭𒊕𒈨𒃻𒀸𒊮𒋙𒁺𒄑	STB
𒂍𒃲𒁹𒀭𒊹𒆕𒀀	STB
𒌨𒊒𒁍𒌓𒈨𒌍𒁍𒁕𒈨𒌍𒂅𒌒𒊮𒁉	NEA
𒊹𒀸𒌗𒍩𒉌𒌓𒁺𒅅	STB
𒀭𒀝𒉺𒆤𒆧𒆳𒀭𒂊𒌋𒆠𒁴𒄑	STB
𒀀𒈾𒊩𒆷𒄿𒄫𒊑𒅁	STB
𒂄𒈪𒅟𒅖𒌅	MPB
𒁁𒉌𒅀𒅇𒋙𒌋𒇽𒉡𒌉𒁕	NEA
𒀭𒂡𒊑𒁕𒀭𒁕𒀀𒊭𒈦𒋫𒆠	SUX
𒀸𒌋𒅗𒀀𒇉𒄯𒊏	NEB
𒀭𒄑𒉢𒈬𒄀𒈾	NEB
𒍝𒆪𒋾𒋼𒄑𒈨	STB
𒃻𒆠𒆗𒀕𒆠𒊹𒌑𒍑𒀭𒌑𒅎𒈥𒌅𒁕𒂍	LTB
𒀀𒈾𒍪𒀊𒈨𒌍	OLB
𒈠𒀀𒃮𒁉𒋗𒉡𒀀𒈾𒉺𒀭	NEA
𒀭𒌓𒋫𒍇𒇻	SUX
𒊩𒇷𒈾𒆪𒋙	LTB
𒅇𒈗𒆳𒅟𒀸𒊺𒋗𒌓𒄿𒉡𒈠	MPB
𒊹𒀸𒀯𒈨𒌍𒀉𒋰𒅆	STB
𒈗𒂗𒅀𒅇𒇽𒈨𒌍𒃲𒈨𒌍𒋗	MPB
𒃻𒉆𒈠𒌌𒄿𒉆𒁷𒌋𒆠𒄿𒂍𒋗𒈫𒈬𒈨𒌍𒀸𒋗𒈫𒊹	LTB
𒀀𒈾𒄞𒋗𒆪𒅆	OLB
𒀸𒋗𒈫𒊹𒌉𒃻𒊹𒈠𒆟𒂊𒋛𒀀𒌓𒈬𒉺𒋡𒊑𒁹𒌋𒅗𒄭𒄑𒊒𒁀	LTB
𒋦𒂍𒊹𒈥𒁲𒄿	NEA
𒄬𒋛𒀭𒉡𒋆	NEA
𒉺𒅆𒈬	SUX
𒋳𒈠𒁀𒁁𒉌𒈬𒌓𒀀𒈾𒋗𒁄𒄊𒈨𒌍	MPB
𒊮𒊹𒀀𒋛𒊑	OLB
𒉆𒄩𒅈𒋾𒀭𒂗𒍪𒁁𒂖𒉌𒉌𒉺𒊩𒍑𒁇	OLB
𒇽𒁀𒋼𒄣	NEA
𒊹𒊕𒊩𒆳𒀴𒈨𒌍𒊭𒄿𒈾𒆠	OLB
𒅇𒋗𒉡𒆠𒄿𒀭𒉌𒄿𒅅𒄭𒁍𒌋𒉌	NEA
𒀭𒅟𒃲𒀭𒀫𒌓	SUX
𒀀𒈾𒂍𒅆𒁾	OLB
𒀀𒄯𒇽𒈨𒌍𒊭𒌅𒊺𒅁𒁉𒅋𒀀𒈾𒈗𒂗𒉌𒅟	MPB
𒀸𒀀𒈨𒌍𒇷𒁕𒁍𒌋	STB
𒀀𒈾𒄿𒁀𒀭𒉌𒀭	OLB
𒊑𒄴𒌓𒊭𒀸𒊮𒁉	NEA
𒌝𒈠𒀀𒈾𒁁𒉌𒅀𒀀𒈠	NEB
𒌋𒊩𒈠𒃮𒁉𒀀𒈾𒄑𒊒𒁀𒊩𒋙𒃻𒌓𒈬𒀸𒁈𒈬𒈨𒌍𒅅𒁉𒅆𒁺	LTB
𒌅𒈾𒄴𒄯	STB
𒌌𒀉𒋫𒁷𒄿𒂟𒌅𒅆𒁾𒃻𒆷	NEB
𒀀𒀀𒈾𒁷𒌁𒆠𒉺𒉡𒋙𒉡	NEB
𒀀𒊮𒀭𒊩𒌆𒄈𒍪𒅟	SUX
𒀭𒌉𒍣𒀭𒄑𒍣𒁕𒀀𒄩𒈪𒅖𒅁𒉺𒀠𒋢𒈠	STB
𒀭𒀀𒈨𒀀𒄘𒀀𒌨𒊕𒃻𒄿𒃻𒊕𒀾𒁍	SUX
𒊮𒊑𒁺𒌓𒌉𒈨𒌍𒆗𒀴𒊏	OLB
𒊹𒃻𒅅𒁉𒅆𒁺𒀀𒈾𒊹𒌋𒁕𒄩𒆷𒃻𒉣𒇬𒃻𒅅𒁉𒅆𒁺	LTB
𒄿𒋫𒀭𒈾𒅟𒀀	NEA
𒊹𒈨𒂟𒈨𒌍	NEA
𒀊𒉺𒀭𒀭	OLB
𒁹𒁁𒂖𒋫𒉌	OLB
𒄩𒀭𒁹𒂊𒈬𒄣𒌌	NEB
𒌑𒊺𒍝𒋙𒌌𒌅𒂍	NEB
𒆷𒄿𒇷𒅟𒌑𒈠𒀀𒀀𒁺𒁉𒀉	NEA
𒃽𒐊𒁹𒆪𒊹𒈨𒊹𒅆𒂊𒋼𒆷𒀀𒄊𒊹𒈨𒌍	NEB
𒄴𒄯𒀀𒄭𒋫𒌋𒅗𒀀𒈾𒌌𒇻𒂊	NEA
𒋛𒅇𒇽𒈾𒍢𒊒	NEB
𒅇𒊹𒀸𒉺𒉌𒆪𒉡	NEB
𒁹𒀭𒀀𒀀𒈾𒁉𒅖𒋾𒌉𒊩𒃮𒌉𒊩𒀀𒉌	OLB
𒋗𒉺𒀠𒄊𒈨𒌍𒋢𒊺𒉌	MPB
𒃻𒈗𒌋𒀀𒁺𒌋	NEB
𒇽𒀴𒈗𒈠	MPB
𒊏𒄴𒀭𒂊	STB
𒄷𒊺𒂟𒄭𒀀𒍣𒈠𒆳𒅥	STB
𒀀𒈾𒊹𒋀𒋙𒉡𒀀𒈾𒌓𒈬𒍝𒀀𒌓𒀸𒀭𒁷𒀪𒈪𒋻	LTB
𒇺𒀪𒀠𒇻𒋙𒌌𒌅𒀀𒂵𒀀𒌋𒌋𒈾	NEB
𒀭𒊹𒊭𒌷𒇹𒀭	NEA
𒁹𒂍𒊕𒆸𒆠𒌑	NEB
𒂍𒆧𒉡𒅅𒂠	SUX
𒅔𒉌𒁍𒍑	NEB
𒌅𒄴𒄩𒊍	STB
𒉌𒌓𒄯𒊏𒀭𒍝𒆳	SUX
𒅇𒀭𒂗𒍪𒅁𒉌	OLB
𒋠𒋛𒅋𒈬	SUX
𒉺𒂍𒍑𒁇	OLB
𒋫𒈬𒀜	NEA
𒀀𒃻𒇽𒁶𒀀𒃻𒇽𒉺	LTB
𒊮𒊒𒁮	MPB
𒄈𒋢𒆠𒄰	SUX
𒋗𒅀𒅇𒋗𒄩𒍝𒉡𒋼𒈨𒌍𒉺𒁼	MPB
𒌉𒃻𒀀𒀸𒄷𒌓𒊮𒁉𒋙𒊩𒋰𒂁	LTB
𒍝𒄢𒆬𒃻𒈨𒊕𒋫𒌑𒆠𒉡𒀸𒂔𒊩𒈬𒃻	STB
𒀀𒋢𒄴𒊏𒌓𒊹𒆚𒊹𒁀𒆷𒁲𒄿	NEA
𒋳𒈠𒊭𒊒𒀀𒈾𒋗𒁓𒊑𒋳𒈠𒁕𒈬𒀀𒈾𒀸	MPB
𒌷𒀀𒆠𒈠𒁲𒂊𒊻𒊓𒄠	NEB
𒄿𒈾𒄷𒇷	MPB
𒊹𒋀𒈨𒌍𒃻𒀀𒌉𒋙𒃻𒊹𒀭𒈾𒈾𒀀𒌑𒉌𒇷	NEB
𒊩𒌉𒄷𒈠𒋛𒌉𒊩𒉌	OLB
𒊹𒀭𒉺𒈾𒀪𒀉𒄯𒀭𒁇𒇻𒊻𒁁	NEB
𒅇𒄷𒇻𒁍𒍑𒌓	STB
𒁮𒃼𒊏	SUX
𒀀𒈾𒌋𒅗𒄭𒐊	NEB
𒃻𒆠𒋀𒈨𒌍𒋙𒉡𒅇𒂗𒈨𒌍𒄩𒆷𒈨𒌍𒋙𒉡𒃮𒁉𒀀𒈾	LTB
𒀴𒈬𒉡𒌒𒁉𒀀	SUX
𒊹𒊹𒌋𒊹𒋗𒋫𒌅𒌋𒈗𒆳𒊻𒈾𒂼𒀾	STB
𒌉𒂍𒃲𒆳𒌑𒈠𒅈	STB
𒀀𒈾𒊭𒀀𒋗𒋗	MPB
𒊑𒄴𒍮𒌋𒊏𒀀𒁺	STB
𒁲𒉈𒅔𒅗𒂵𒂊𒀀	SUX
𒂊𒀠𒌑𒉌𒅁𒄷	STB
𒁹𒀀𒌨𒊓𒀭𒁯𒉽𒁀𒉡𒌑𒌓𒀀𒈾𒉚	LTB
𒊩𒈠𒈠𒆷𒄿𒈬𒊒	NEB
𒆠𒄿𒌑𒍮𒉌	NEB
𒀭𒊩𒌆𒅆𒉄𒁍	SUX
𒅆𒊹𒀭𒌈𒀭𒃽𒂔𒀭𒈾𒈾𒀀𒀭𒃽𒃻𒊕𒌋𒀭𒈨𒌍𒂍𒋙𒉡	LTB
𒀭𒊩𒌆𒉺	SUX
𒀭𒊒𒌦𒈠	SUX
𒌑𒅎𒋛𒁲𒁕𒂍𒈬𒌁𒌈𒃻𒆍𒃲𒌑𒃻𒊹	LTB
𒀴𒀭𒀭𒈥𒌅	OLB
𒈬𒈨𒌍𒀉𒋰𒋗𒌑𒌋𒊹	LTB
𒆏𒁍𒅖𒌅𒂍𒋾𒀴𒅟	MPB
𒁄𒄩𒅟	NEB
𒃲𒆠𒈲	NEA
𒂍𒅎𒆳𒊏𒂍𒌋𒌆𒁀𒉌𒋙𒌋𒂍𒂍𒌈𒋙𒌑𒌓𒌋𒆠𒊒𒁀𒀀𒋙	LTB
𒌶𒁉𒁰𒆬𒍪𒀊𒁶	SUX
𒇽𒈬𒆸𒋢𒉺𒈨𒌍𒃻𒌉𒌋𒌋	NEA
𒄷𒄭𒊑𒌨𒈲𒌨𒉡𒍢𒊒𒌒𒋡𒃻	STB
𒀀𒆠𒅀𒀀𒅆𒌓𒊹𒄰	NEA
𒌓𒌑𒈠𒀀𒋧𒈠𒈠𒄭𒅕	NEA
𒄿𒋼𒁍𒍑𒃻𒀭𒈨𒌍𒅟𒌋𒀴𒅟	NEB
𒀭𒄑𒁇𒈾𒁷𒈠𒅟𒇷𒂊𒀀𒈾𒌉𒈨𒌍𒃲𒈨𒌍	STB
𒌌𒌑𒊺𒍝𒀾𒋙𒊹𒉣𒆷𒀀𒅅𒋫𒁀𒊍	NEB
𒄑𒊒𒁀𒈨𒌍𒈬𒈨𒌍	LTB
𒊹𒌓𒊹𒆚𒀭𒊹𒌋𒀭𒌓	STB
𒊹𒂆𒅎𒁍𒁕𒀀𒈾𒊮𒊹𒈠𒈾𒍏𒄭𒀀	STB
𒆗𒋙𒌋𒊹𒀭	NEB
𒌋𒌋𒉡𒌑𒁕𒈨𒈨𒉌	NEA
𒊹𒊹𒆠𒁺𒋢𒄀𒈾𒁺𒄑	STB
𒀉𒋾𒅀𒀸𒋳𒈠𒀀𒆷𒆠𒅀	MPB
𒈠𒀀𒀀𒈾𒇽𒃲𒈨𒌍	NEA
𒅋𒌨𒆪	NEB
𒇽𒀀𒆥𒈨𒌍𒊭𒊹𒁺𒆰𒀸𒌋𒅗𒋙𒅋𒆷𒆪𒉌𒂊𒄫𒌈	NEA
𒊭𒌉𒆠𒉺𒋼𒋛𒀭𒌓	OLB
𒀀𒈾𒁷𒍣𒈨𒌍𒃻𒂗𒐊	NEB
𒆠𒆪𒉆𒈗𒆷𒉌	SUX
𒅇𒀀𒄭𒀀𒌈	OLB
𒀭𒂔𒈾𒋗	SUX
𒄿𒈾𒆳𒈥𒌅𒄿𒆷𒂵𒄠	MPB
𒌉𒊩𒃻𒁹𒀭𒈾𒈾𒀀𒈬𒇽𒀴𒂍𒃲𒃻𒋫𒌉𒊒𒁮𒊹𒀜	LTB
𒀸𒉡𒊨𒅇𒀭𒋫𒆷𒋼𒊐𒋙	STB
𒄑𒍣𒍪𒍣𒌓𒇽𒉽	STB
𒀭𒁲𒋻𒀭𒆠𒋗	SUX
𒂄𒈬𒀀𒈾𒂗𒉣𒋙𒉡	NEB
𒊹𒀸𒌓𒈿𒀀𒀀𒀭𒋩𒉣	STB
𒀭𒇽𒋛𒃻𒊏𒋗	SUX
𒀴𒀭𒈹	OLB
𒊹𒇽𒋃𒀀𒃻𒀀𒀕𒆠𒌗𒉈𒌓𒊹	LTB
𒊹𒀭𒀝𒈾𒁷𒈬	NEB
𒀴𒀭𒊩𒌆	OLB
𒊹𒈧𒈨𒌍𒆳𒁁𒄬𒇻	NEA
𒌋𒀭𒊻𒋢	NEB
𒃻𒀉𒍣𒂵𒅟	SUX
𒆳𒆳𒆠𒆪𒉌𒄴𒋾𒆪𒈨𒌍𒀭𒈨𒌍𒀬	STB
𒁹𒀭𒌓𒁉𒁲𒅅𒇷𒀉	OLB
𒆷𒉺𒉌𒁕𒀀𒆠	NEB
𒀴𒆠𒋾𒋗	MPB
𒆠𒄿𒅎𒄣𒌅	NEB
𒊑𒁺𒌓	OLB
𒀀𒁲𒆷𒁕𒀪𒋾𒌋𒂄𒈠𒈾𒋾	NEB
𒉈𒈬𒊭𒊹𒀭𒀫𒌓𒌉𒍑𒋧𒈾	NEA
𒇷𒂊𒈬𒊒	NEA
𒈗𒊑𒂗𒅀𒀀𒄯	MPB
𒃻𒈗𒃻𒀀𒈾𒈾𒁕𒉡𒌋𒈠𒄩𒊒	NEB
𒀀𒈾𒌋𒅗𒄭𒆠𒊒𒁀𒀀𒈬𒈨𒌍𒀉𒋰𒋗𒌑𒁹𒀭𒈾𒈾𒀀𒈬𒈬𒈨𒌍	LTB
𒆳𒈗𒂗𒅀	MPB
𒃻𒈾𒋆𒇷𒀀𒈾𒀭𒍝𒃼	STB
𒈤𒊒𒋼𒃻𒀸𒁍𒌦𒉌𒅟𒊮𒁍𒍑𒃻	NEB
𒊮𒊭𒆷𒀜	OLB
𒅆𒅔𒍣𒊒𒌑𒃻𒌓𒈬𒀸𒊹𒌓𒈬𒀸𒌓𒈬𒈨𒌍𒈬𒈨𒌍𒄑𒊒𒁀𒇽𒄈𒇲𒌑𒌓	LTB
𒌌𒄿𒈠𒄿𒁕𒈜𒋀𒋙𒉡𒈠	NEB
𒀀𒈾𒂟𒈨𒌍𒅇𒌑𒌌𒌅𒁕𒉡𒂟𒈨𒌍𒅀𒅆	MPB
𒆬𒌓𒀀𒀭𒊹𒂆𒉚𒅆𒅔𒍣𒊒𒌑𒃻𒌓𒈬	LTB
𒀀𒃻𒀀𒀀𒈾	LTB
𒌦𒈨𒌍𒆳𒈠𒆷𒀀𒈾𒍝𒀀𒀀𒀜𒋾𒄿𒉌𒃮𒁉	NEB
𒆳𒀸𒋩𒆠𒋫	NEB
𒄿𒃮𒁀𒀀𒌝𒈠	NEB
𒌅𒊬𒋗	STB
𒄿𒄷𒊻𒍪𒅆𒈫𒂟𒌈𒉌𒋝𒁾𒊬𒊒𒋾𒊭𒀸𒈗𒈨𒌍	STB
𒁹𒀭𒇡𒉺𒉌𒌈𒌝𒈪	OLB
𒊕𒉡𒆳𒌦𒈾𒀾𒂊𒈠𒉺𒉡𒋙𒊕𒉡𒆳𒄿𒁉𒂖	STB
𒉺𒇻𒇽𒀠𒆠	OLB
𒌀𒈨𒌍𒊩𒊩𒆳𒆕𒌈𒀸𒋗𒈫𒊹𒈤𒋥𒂊𒋩𒌈	LTB
𒉡𒀭𒍪𒌑𒋛𒋢𒌑	STB
𒅖𒇯𒋺𒁉	SUX
𒊭𒉿𒋼𒁍𒍑	MPB
𒄵𒋫𒀉𒋙𒁉𒈩𒅘𒆷𒁀𒋗	STB
𒀀𒊬𒉌𒄑𒄭𒃻𒀭𒈨𒌍𒅟	NEB
𒌋𒌋𒉡𒀜𒋫𒇽𒀀𒁀	NEA
𒀀𒈾𒆳𒈠𒈾𒀀𒀀	NEA
𒅇𒀊𒉺𒀭𒀭	OLB
𒇽𒀫𒁕𒆠𒈨𒌍	NEB
𒌋𒌋𒌀	SUX
𒇽𒉺𒁼𒅆𒂂𒄿𒈾	MPB
𒀭𒆷𒂵𒂷	STB
𒅔𒈾𒁉𒁺𒉏𒈠	OLB
𒀝𒁉𒆠𒄿𒄿𒋾𒁍𒋗𒀀𒈾𒊭𒋗	MPB
𒅇𒊕𒆠𒈪𒋚𒌈𒆠𒊒𒁀𒀀𒈬𒈨𒌍𒆠𒊒𒁀𒀀𒈬𒈨𒌍	LTB
𒇽𒍪𒌑𒊒𒅇𒉿𒆷𒆪	MPB
𒁹𒈪𒅋𒆠𒀉𒋾𒈗𒇽𒌆	OLB
𒌉𒉈𒉈𒁕	SUX
𒁹𒍝𒅈𒊑𒄣	OLB
𒅇𒉺𒈥𒌅𒈨𒌍𒇽𒆍𒀭𒊏𒆠	OLB
𒀀𒈾𒌋𒅗𒊭𒈗𒁁𒉌	NEA
𒀸𒁾𒈨𒌍𒀾𒄙𒊍𒊩𒌨𒀊𒊑𒂊𒈠𒀀𒈾𒋫𒈥𒋾	STB
𒃻𒋗𒀭𒂗𒍪𒊺𒈪𒉺𒀀𒋛𒀸	OLB
𒈜𒆤𒁺𒇽𒂟𒈨𒌍𒋙𒉡	NEA
𒊮𒂍𒀀𒋛𒊑	OLB
𒇻𒌑𒈾𒋾	MPB
𒊭𒅖𒌅𒌷𒋗𒄩𒉌𒆠	OLB
𒊹𒈠𒈾𒋼𒅕𒋛𒌅𒊹𒈠𒈾𒍪𒆪𒌑𒊹𒈦𒈠𒈾𒉌𒌓	STB
𒊹𒀀𒈾𒌓𒈬𒍝𒀀𒌓𒀸𒀭𒁷𒀪𒁍𒌓𒀀𒄩𒀀𒈩𒀀𒈾𒈬𒊒𒄣𒃻𒄑𒊒𒁀𒈬𒈨𒌍	LTB
𒇽𒋢𒊓𒉌	NEA
𒆷𒄠𒀭𒌓𒈾𒉺𒄭	STB
𒀀𒁲𒀭𒊹𒀭𒂗𒆤𒌋𒀭𒈦𒈗	NEB
𒈨𒌍𒅀𒀀𒁍	MPB
𒌷𒈠𒊏𒀜	NEB
𒉌𒌓𒈩𒁹	LTB
𒀀𒈾𒈾𒍝𒅈𒌷𒋗𒅇𒉿𒁲𒉆	MPB
𒆜𒁁𒆷𒉡𒌝	OLB
𒂊𒋼𒋼𒆥	NEA
𒀀𒈾𒌷𒆠𒅇𒋾𒈠𒂵𒊒	MPB
𒀀𒈾𒆪𒉺𒅆𒊒𒃻𒆍𒇽𒈬𒆠𒉌𒂊	NEB
𒁹𒀀𒈠𒀭𒄩𒀜𒁉𒇽𒊭𒊏	MPB
𒀭𒄑𒄯𒈤𒋤𒋤𒀭𒊩𒌆𒅊	SUX
𒄫𒈩𒉽𒅅𒈨𒌍	STB
𒂕𒉌𒋛𒅔𒆠	OLB
𒋗𒌑𒂼𒈗𒁁𒉌𒅀𒄿𒁲	NEB
𒊭𒅈𒊒𒊭𒈗𒂗𒅀	MPB
𒂟𒉌𒉽𒀸𒀞𒊒𒌓	STB
𒂗𒐊𒆷𒀾𒌓𒃻𒋾𒅆	NEA
𒊹𒀭𒀝𒅅𒁉𒀭𒀸𒋩𒀭𒌓𒌋𒀭𒀫𒌓	NEB
𒀴𒀭𒈥𒌅	OLB
𒁲𒂊𒋾𒆠𒈲𒊩𒋙𒃻𒌗𒁈𒃻𒂊𒌑𒃻𒌗𒁈𒊹𒋗𒌋	STB
𒈠𒄯𒈗𒊑𒂗𒅀	MPB
𒄑𒋢𒊒𒈗𒁁𒉌𒄿𒃮𒁉	NEA
𒀀𒊏𒀪𒀀𒄠𒀀𒈾𒇽𒀴𒈨𒌍	MPB
𒋗𒆸𒆸𒊹𒊩𒋙𒌑𒍑𒊹𒈦𒌑𒊕𒆠𒈨𒌍𒉺𒆠𒊒𒁀𒀀	LTB
𒋦𒆜𒊭𒀸𒌷𒅆𒊹𒈨𒌍𒁺𒌋𒉌	NEA
𒀭𒍣𒍝𒉡𒆳𒌉𒀀𒉌	SUX
𒈗𒉡𒊺𒆗	NEB
𒇽𒌷𒌅𒋗𒌌𒋾𒆠𒄿𒉡𒈠𒄿𒍝𒁀𒌅𒈪	MPB
𒆸𒁀𒀀𒋾𒀸𒆳𒅅𒈨𒌍	STB
𒉺𒌓𒀭𒀝𒀸𒊬𒌓𒉡𒄑𒌋𒀸𒈨𒊕𒌓𒉡𒄿𒆗𒇷	STB
𒊺𒉡𒉌𒉘𒂊	SUX
𒄑𒅅𒈨𒌍𒂊𒆪𒉡𒇻𒆷𒄿𒉻𒋾𒀀	STB
𒁹𒂍𒆳𒍝𒄫	LTB
𒄑𒈨𒌍𒈾𒀀𒊑𒈠𒄭𒍢	NEA
𒌨𒁀𒋫𒂊𒄫𒂊𒈨𒌍	NEB
𒉌𒉌𒄿𒁷𒉆𒊭𒌉	OLB
𒌋𒅗𒅀𒉡𒄥𒌈𒌋𒅗𒌷𒍮𒈬𒌨	MPB
𒊭𒈗𒁕𒈠𒀜𒋡𒁺𒆏𒁉𒆠𒅎𒋾𒅟	MPB
𒂍𒄈𒋢𒆠𒅟𒉌	SUX
𒅅𒋫𒀠𒀪𒋙𒉡	NEA
𒊭𒅖𒌅𒆍𒀭𒆷𒋫𒊏𒀝	OLB
𒌝𒈠𒀯𒀠𒈜𒀸𒉣𒇬𒊹	NEB
𒈗𒁁𒉌𒇻𒌋𒁕𒄩	NEA
𒊹𒈬𒈨𒌍𒀉𒋰𒋗𒌑𒌉𒃻𒌉𒃻	LTB
𒊹𒌉𒃻𒊹𒌑𒊕𒆠𒀭𒅎𒈥𒌅𒁕𒂍𒅎𒆳𒊏𒃻𒂍𒈬𒈨𒌍𒊹𒌑𒊕𒆠𒆠𒋫𒅎𒆳𒊏	LTB
𒄿𒍢𒌋𒈠𒀀𒁺𒈠𒆷𒁀𒋗𒌑𒃮𒁉𒌋𒄑𒊒𒁀𒋙𒊹	LTB
𒐕𒐕𒐕𒐕𒐕𒐕𒄘𒌦𒆬𒌓𒊹	SUX
𒅇𒀸𒋰𒁇𒁾𒁉𒅀𒅇𒇽𒆥𒅀	MPB
𒁕𒋻𒁀𒊍𒌋𒊹𒋀𒋙𒊹𒈪𒋻𒌑𒊕𒆠𒀭𒋫𒅎𒈥𒌅𒁕𒂍	LTB
𒊮𒊕𒀴𒊭𒂍𒀀𒁁𒂖𒉌𒉌	OLB
𒊹𒀸𒄑𒊒𒁀𒈨𒌍	LTB
𒄿𒁷𒉆𒀉𒁷𒉆𒈠	MPB
𒇻𒄯𒇻𒌑𒄯	MPB
𒁁𒉌𒈬𒌈	STB
𒁾𒈨𒌍𒀾𒄙𒊍𒊩𒌨𒀊𒊑𒂊𒈠	STB
𒊹𒌀𒈨𒌍𒌋𒌉𒈨𒌍𒃻𒀸𒋗𒈫	LTB
𒀴𒈨𒌍𒉌𒊭𒈗𒊹𒊹𒀸𒅆𒅀𒄿𒍝𒍪	NEA
𒀸𒂂𒋙𒊒𒌓	STB
𒌋𒁕𒈬𒍮𒌑𒃻𒂍𒈬𒈨𒌍𒊹𒌑𒊹𒁕𒋻𒋗𒈫𒉡𒈬𒋥𒀀𒇉𒀭𒈹𒊹𒑚𒌑	LTB
𒃻𒇽𒆗𒁺𒀉	NEB
𒀀𒀉𒋾	NEB
𒅅𒁉𒈠𒌝𒈠𒇽𒀀𒆥𒅟	NEB
𒌋𒀭𒈨𒌍𒂍𒋙𒉡𒃮𒁉𒃻𒌗𒋢𒈬𒀭𒈾𒋢𒆗𒈬𒀭𒈾	LTB
𒊹𒉌𒈝𒈬𒌋𒀸𒆜𒋗𒌓	STB
𒀭𒈗𒅟𒄀𒌌𒋗	SUX
𒂗𒋼𒈨𒈾𒊏	SUX
𒇽𒊕𒈗𒇸𒇷𒄰𒈠	NEB
𒆠𒄿𒀉𒁍𒌑𒆠𒄿𒅋𒇷𒆪	NEB
𒀲𒆳𒊏𒈨𒌍𒁉𒆷𒀀𒉌𒀸𒅕𒋾𒈗𒇻𒉋	NEA
𒌒𒁍𒉡𒌒𒁍𒄷	STB
𒀭𒂄𒄀𒍑𒆗𒂵	SUX
𒌝𒈠𒁹𒀴𒈗	MPB
𒊹𒀯𒊕𒈨𒃻𒀸𒊺𒅕𒋾𒅅𒌅𒌦𒈗𒈨𒌍𒉽𒈨𒌍𒁲𒈨𒌍	STB
𒊹𒀭𒈪𒂗𒉣𒌓𒉌𒇷𒂗𒂟𒅕𒍑𒋫𒉌𒄴𒈗	STB
𒊹𒇽𒀴𒋢𒁹𒋺𒆗𒉡𒀭𒈾𒈾𒀀𒇽𒀴𒋢𒊹𒇽𒀴𒋢	LTB
𒁹𒁁𒂖𒋾𒊑𒈨𒅔𒉌	OLB
𒀀𒈾𒈗𒆳𒆳𒁁𒉌𒄿𒉌𒌨𒊒𒁍	NEB
𒅅𒋫𒁀𒀾𒋙𒌝𒈠𒋛𒄷𒂊𒁍𒍑	NEB
𒊹𒁀𒁲𒀪𒀭𒀸𒉺𒉌𒅟	NEA
𒃻𒁀𒈗𒀀𒈾𒀭𒈗𒄊𒊏	OLB
𒈗𒁁𒅀𒀀𒈾𒆪𒅇𒀴𒆠𒀉𒋾𒋗	MPB
𒅖𒌅𒌷𒈠𒀝𒁕𒇷	MPB
𒌉𒊩𒈠𒀀𒉌	NEA
𒀀𒈾𒀭𒂗𒊌𒁷	NEB
𒈪𒅎𒈠𒄠𒈠𒄿𒈾𒍜𒊮𒁉𒅟	MPB
𒊓𒄭𒅕𒁺𒊑𒈠𒇡	STB
𒀭𒋢𒈬𒋡𒀭𒌑𒄭𒀀𒄩𒆪𒈫	SUX
𒄿𒁕𒉡𒌋𒌋𒋙𒌑𒈠𒀀𒊹	NEA
𒅇𒀀𒊮𒈨𒌍𒅀𒂗𒈾𒅟𒀸	MPB
𒃮𒊑𒊭	STB
𒊹𒀀𒁺𒊹𒊹𒊹𒁲𒂊𒊹	STB
𒋫𒀭𒈾𒅟	NEA
𒉌𒉌𒀾𒋗	OLB
𒄀𒄷𒊻𒍢𒂊𒋾	NEB
𒊺𒉻𒈨𒌍𒊭𒊹𒄑𒈪𒀭𒂗	NEA
𒊭𒅖𒌅𒀭𒊓𒈨𒄿	MPB
𒋗𒆸𒆸𒊹𒑛𒌑𒍑𒊹𒑛𒌑𒊕𒆠𒈨𒌍𒉺𒆠𒊒𒁀𒀀𒈬𒈨𒌍	LTB
𒀀𒈾𒉌𒃻𒆷𒋫𒊓𒄯𒌋𒉌	STB
𒈗𒁁𒉌𒅀𒌑𒁄𒆷𒂅	NEB
𒊹𒇽𒀿	LTB
𒆏𒁉𒀀𒉿𒋼𒈨𒌍	MPB
𒄿𒋼𒅕𒁍	NEB
𒋀𒋙𒉡𒌉𒃻𒊹𒇽𒁃𒀀𒈾𒌓𒈬𒍝𒀀𒌓	LTB
𒀭𒀀𒁲𒋻𒊺𒈤𒀭𒁲𒋻	SUX
𒈬𒈨𒌍𒃻𒊩𒊩𒆳𒅟𒀀𒈬𒈨𒌍𒀀𒈾𒌓𒈬𒍝𒀀𒌓𒋗𒌑	LTB
𒇽𒋛𒌓	LTB
𒀸𒋗𒈫𒌉𒊩𒃻𒈠𒆟𒂊𒋩𒌓𒈬𒉺𒋡𒊑𒁹𒌋𒅗𒄭𒄑𒊒𒁀𒈨𒌍𒈬𒈨𒌍	LTB
𒅇𒆠𒄿𒅀𒄠𒌈𒌓𒋫𒈪	MPB
𒁹𒆠𒆗𒀭𒃽𒌋𒌉𒈨𒌍𒃻	LTB
𒌉𒈾𒊷𒂵	SUX
𒁹𒁍𒄷𒊒𒊭𒀠𒋗	MPB
𒀀𒈾𒌓𒈬𒍝𒀀𒌓𒀉𒋺𒁷𒆬𒌓𒀀𒀭𒊹𒂆𒉚𒄑𒊒𒁀𒈨𒌍	LTB
𒀴𒋗𒅇𒋗𒌓	MPB
𒉌𒀀𒈾𒁕𒀀𒆠	NEB
𒁹𒉌𒉌𒄿𒆠𒊭𒄠	OLB
𒊹𒊹𒌑𒊕𒆠𒆠𒋫𒅎𒆳𒊏𒁕𒂍𒀀𒋢𒌒𒁍𒈨𒌍𒃻𒀀𒃻	LTB
𒀀𒈾𒉚𒌀𒈨𒌍𒀀𒈾𒀀𒃻𒀀𒃻	LTB
𒊹𒋢𒌑𒋫𒇽𒃲𒈨𒌍𒃮𒁍	NEA
𒌨𒂠𒊭𒂍𒋗𒅇	MPB
𒁹𒆪𒊑𒌈	OLB
𒅆𒈨𒌍𒈪𒀉𒂵𒊑	MPB
𒇽𒀭𒂄𒄀𒊏	SUX
𒆬𒌓𒆬𒄀𒁕𒀀𒋼	NEB
𒆷𒊮𒁉𒈗𒈨𒌍𒂗𒈨𒌍𒐊𒆷𒂖𒇷	NEB
𒇽𒂈𒅇𒊹𒍣𒉌𒂊𒉌	NEB
𒆳𒄣𒌋𒀀𒀀𒊭𒊹𒌑𒊑𒅅𒀀𒈾𒇽𒉺𒅁𒊒𒋼	NEA
𒁳𒁉𒃻𒉺𒌓𒀭𒀫𒌓𒈠𒀪𒁹𒌶𒈠𒁹𒆷𒌉𒁷𒌁𒆠𒉡𒌑𒆗𒇴	STB
𒀭𒊹𒋫𒀭𒂊𒌑𒊺𒊏𒁕𒀀𒉌𒈗𒁁𒉌𒀸𒌋𒅗	NEA
𒆠𒊒𒁀𒀀𒆠𒁴𒊬𒈤𒃻𒆠𒆗𒀕𒆠𒊹𒌑𒍑𒀭𒌑𒅎𒋛𒁲	LTB
𒀭𒀫𒀭𒂗𒍪𒆠𒉘𒋀𒀊𒆠𒈠	SUX
𒀀𒇉𒉣𒋫	SUX
𒁹𒀭𒂗𒆤𒀀𒁉	OLB
𒀀𒈾𒆳𒅟𒊏𒁺𒉌𒅀𒀸	MPB
𒀭𒁕𒃶𒈠𒀭	OLB
𒄿𒋼𒇽𒈨𒌍𒁁𒂖𒅈𒉌𒋗	MPB
𒇽𒂗𒈨𒌍𒄩𒆷𒈨𒌍𒋙𒉡𒃮𒁉𒀀𒈾𒊹𒂆𒆬𒌓𒋡𒇻𒌑	LTB
𒂊𒈤𒆠𒋩𒊏	SUX
𒀸𒌋𒅗𒋙𒉌𒅁𒌅𒉌	NEA
𒌑𒈥𒊩𒈠𒀪𒀀𒁲𒊹𒀀𒈾𒊩𒋼𒀀𒌈𒊩𒌆𒋙𒉡𒀀𒈾𒌓𒈬	LTB
𒁹𒊑𒁀𒌈	OLB
𒃻𒂵𒊏𒅇𒄑𒋗𒃸	SUX
𒀀𒈾𒆪𒀀𒈾𒇡𒆪𒉡𒅇𒁲𒅁𒁉𒆪𒉡	NEA
𒊺𒆠𒇴𒀠𒁺𒀀𒁶	SUX
𒇽𒉌𒋩𒌑𒌓𒈪𒋻𒌓𒈬𒀸𒌓𒊹𒈬𒈨𒌍𒃻𒌗𒊻𒋢	LTB
𒀭𒂗𒉽𒉽𒋗	SUX
𒁹𒀭𒀫𒌓𒌝𒈠𒋾	OLB
𒇽𒈬𒌁𒉈𒂊𒈬𒃻𒊹𒀭𒀝𒌑𒊩𒅆	NEB
𒁵𒀭𒉌𒌅𒌑𒊓𒄭𒊒𒌋𒉌	NEA
𒀭𒂍𒆳𒊑𒌈𒀭𒂍𒆳𒊑𒌈𒈫	STB
𒁁𒇇𒊹𒅇𒌅𒆳𒁉𒉽𒁳𒁁	STB
𒀴𒅟𒀀𒈾𒄈𒈨𒌍	MPB
𒀭𒆠𒂗𒄀𒈾𒆤	SUX
𒊺𒀭𒉺𒇻𒁮𒃼	SUX
𒀀𒈾𒅟𒉌𒊹𒀭𒁉𒀪𒁲	NEA
𒄿𒁷𒀭𒅎	OLB
𒅇𒂟𒈨𒌍𒋗𒍣𒂵	OLB
𒀭𒊕𒈦𒋗𒌌𒀭𒌓	SUX
𒌉𒃻𒀀𒀀𒉈	LTB
𒀀𒉿𒋾𒀀𒈾𒈗𒊑𒊭𒉌𒌓	MPB
𒄿𒋢𒊑𒈗𒂗𒄿𒋡𒁉	NEA
𒌝𒈠𒈗𒌑𒌅𒄿𒅆𒀀𒈾𒉿𒅀	NEB
𒃮𒁉𒀸𒇻𒀴𒈨𒌍𒃻𒉡𒌓𒃻𒅔𒅁𒁍𒍑𒈨𒌍𒀸𒌓𒀊𒀊𒈨𒌍𒈬𒀭𒈾	LTB
𒁹𒈾𒌉𒋗	OLB
𒅇𒊑𒄴𒋼𒇽𒊭𒁁𒄬𒈨𒌍	NEA
𒌦𒋡𒊹𒇽𒈾𒁷	LTB
𒄿𒈾𒀭𒈾𒇻𒌑𒄿𒋼𒀭𒉌	MPB
𒁍𒄴𒀭𒈾𒁉𒌝𒄿𒁷𒉆	OLB
𒊹𒀀𒁺𒊹𒊹𒁲𒂊𒊹	STB
𒋗𒄥𒌈	SUX
𒁹𒊑𒅁𒀭𒅎𒅖𒋫𒌓𒀀𒈾𒂗𒋗	MPB
𒀭𒂊𒈝𒈫	SUX
𒀀𒄯𒌑𒉌𒈗	NEA
𒅇𒀀𒄩𒌈𒄿𒁷	SUX
𒀀𒃻𒇽𒁶	LTB
𒀭𒈨𒌍𒅇𒌋𒆠	MPB
𒁉𒋙𒉡	NEA
𒁹𒀀𒈨𒌍𒃻𒁹𒄩𒁲𒀀	LTB
𒈠𒀀𒆜𒉿𒋙𒉡𒆷𒌑𒊺𒁉𒆷	NEA
𒄑𒊒𒁀𒈬𒈨𒌍𒀉𒋰𒋗𒌑𒊹𒌉𒀀𒉌𒌑𒈥𒊩𒈠	LTB
𒅗𒉡𒌝𒂷𒂷𒉈𒀀	SUX
𒁹𒁀𒆷𒂅	LTB
𒁹𒊑𒅁𒀭𒅎𒅅𒁉𒀀𒈾𒂗𒋗𒀀𒈾𒄊𒈨𒌍	MPB
𒄑𒊒𒁀𒈬𒈨𒌍𒀀𒁲𒊹𒌑𒈥𒊩𒈠𒀪𒀀𒈾𒊹𒌉𒃻𒊹	LTB
𒀀𒈾𒆳𒀸𒋩𒆠	NEB
𒄿𒉺𒅁𒌓𒌋𒉌𒅋𒋃𒌋𒉌	NEA
𒄿𒉺𒅁𒊏𒈠𒀀𒊹𒇽𒀀𒆥𒈨𒌍	NEA
𒀕𒆠𒌗𒁈𒌓𒊹𒈬𒊹𒁹𒋛𒇻𒆪𒈗	LTB
𒀭𒄑𒌉𒁕𒅟𒉌𒋗	SUX
𒁕𒈾𒀜𒉽𒉡𒌋𒅗𒅀	MPB
𒀵𒁕𒉌𒂊	SUX
𒀭𒍣𒆗𒆷𒈫	SUX
𒁹𒂍𒀀𒋰𒁀𒂊𒇽𒀊𒉣𒈾𒆠	OLB
𒊹𒀭𒊹𒀭𒌓𒅅𒋗𒁮𒈠	STB
𒀴𒀭𒂗𒆤	OLB
𒅇𒊩𒋙𒃻𒌓𒈬𒀸𒌓𒊹𒄑𒊒𒁀𒈬𒈨𒌍𒀉𒋰𒋗𒌑	LTB
𒄿𒋛𒋙𒈥𒁲𒀀𒋾	NEA
𒈪𒈾𒄠𒀉𒁷𒀀𒈾𒊭𒋗𒉡	MPB
𒁹𒆪𒊻𒍝𒊑	OLB
𒀴𒈨𒌍𒅟𒊹𒀭𒌓𒆕𒀀𒀀	NEB
𒉺𒈥𒌅𒈨𒌍	OLB
𒇷𒅎𒇷𒅅	MPB
𒀀𒈾𒌋𒅗𒁷𒌁𒆠𒆠𒄿𒌑𒊺𒇻𒌑	NEB
𒊭𒊑𒅎𒀭𒂗𒍪𒍣𒂵	OLB
𒁹𒀭𒀫𒌓𒈬𒉡	LTB
𒈬𒃲𒈗	SUX
𒊹𒀸𒌗𒁈𒌓𒊹𒆚𒇽𒇷𒋼𒇸	STB
𒊮𒄘𒌦𒁁𒆷𒉡𒌝𒈛	OLB
𒆷𒂊𒋼𒁍𒍑𒈗𒊒𒂗𒅀	MPB
𒅇𒇷𒁲𒉆𒁁𒇷𒅀	MPB
𒊹𒊕𒊩𒆳𒀴𒊭	OLB
𒂞𒌓𒌓	SUX
𒇽𒉽𒀸𒆳𒋙𒊩𒁕𒌋𒌋𒁺𒁺𒀝	STB
𒈗𒊒𒂗𒇷	MPB
𒌅𒌋𒉌𒀀𒆠	NEA
𒌋𒅗𒌷𒀸𒀸𒄭𒀀𒆠𒁹𒈗𒊑𒂗𒅀	MPB
𒌉𒃻𒌉𒃻	LTB
𒊩𒈠𒃮𒁉𒃻𒀀𒈾𒈪𒋻𒌓𒈬𒄑𒊒𒁀𒇽𒉌𒋩𒌑𒌓	LTB
𒇽𒈬𒈥𒋡𒉡	LTB
𒈾𒀜𒉡𒇽𒈨𒌍𒂡𒅆𒅕𒈠	MPB
𒀀𒉡𒈠𒁹𒀀𒍣𒊒𒌉	MPB
𒇽𒈾𒁷𒀭𒄑𒊒𒁀𒈬𒈨𒌍	LTB
𒀭𒀖𒊮𒉣𒈾	SUX
𒆷𒀀𒈠𒌈	STB
𒀸𒋗𒊹𒊹𒀭𒂗𒋩𒀀𒈾𒈗𒂗𒐊	NEB
𒉌𒊏𒀀	SUX
𒅆𒊹𒀭𒌋𒄥𒌑𒁄𒀖	NEA
𒊩𒆪𒆠𒉘𒂷𒉌	SUX
𒈨𒀭𒂊𒇴𒅕𒍢𒌓𒀀𒈨𒀭𒂊𒆠𒁴𒆠𒋡𒁍𒌋	STB
𒊹𒂟𒈨𒌍𒀸𒊮𒁉𒂟𒈨𒌍𒃻𒈗𒁷𒌁𒆠	NEB
𒈠𒀪𒌑𒌅	NEB
𒊮𒈾𒄰𒁴	OLB
𒌋𒌆𒈝𒇻𒁍𒍑𒄿𒈾	NEB
𒌌𒄿𒉆𒁲𒉌𒌋𒊩𒈠𒀸𒋗𒊹𒅀	NEB
𒍑𒄭𒄭𒂗𒄿𒉡𒈠	MPB
𒀀𒈾𒆳𒄩𒈾𒃲𒁁	MPB
𒈨𒌍𒐊𒀉𒋾𒅅	NEB
𒈪𒄿𒈾𒄠𒀊𒁍𒈾𒈠	MPB
𒀀𒀀𒆷𒆠𒄿𒋫	NEB
𒊍𒉺𒅁𒊏𒈪𒄿𒉡	NEA
𒆬𒌓𒃻𒋫𒄠𒈥𒊏𒀀𒌓	LTB
𒋀𒈨𒌍𒂊𒀀𒉺𒀭	NEA
𒀀𒈾𒅟𒋙𒉡𒊩𒈨𒌍𒆪𒉡𒌉𒈨𒌍𒆪𒉡𒌉𒊩𒈨𒌍𒆪𒉡	STB
𒊹𒀭𒂗𒋀𒈨𒀭𒀫𒌓𒇽𒂗𒁲𒄿𒉡𒃻𒊹𒀭𒂗𒈬	NEB
𒁁𒉌𒀀𒉈𒂊𒈬𒅖𒆲𒀭𒉌	NEB
𒁹𒀭𒈬𒁀𒉌𒀉	OLB
𒀸𒊮𒈠𒈾𒆬𒌓𒀸𒊭𒌋𒌋	NEA
𒈪𒉆𒈠𒆷𒋳𒁀𒀪𒆠𒄿𒀾𒈬𒌑	NEB
𒅇𒋳𒈠𒋼𒋼𒁍𒍑𒆠𒄿𒆠𒀉𒋾𒅇𒌑𒌌𒆠𒄿𒈾	MPB
𒌌𒀀𒊕𒃶𒊺𒋫𒈠𒉌	NEB
𒊭𒀀𒈾𒇽𒃲𒆠𒈲𒌋𒌓	NEA
𒅇𒃻𒇴𒈗𒋙	STB
𒊭𒁍𒊏𒈬𒊭𒇽𒀊𒉣𒈾𒆠	OLB
𒀭𒊩𒌆𒋾𒄬𒌜𒂍𒀀𒆤	SUX
𒀭𒌓𒄿𒊏𒀪𒄠𒋗𒅇𒆠𒄿𒄿𒈾𒀭𒈾𒉌𒄿𒉡𒀭𒈨𒌍𒌑	MPB
𒈠𒀀𒀀	NEA
𒅇𒇽𒃲	NEA
𒀸𒌗𒋗𒃮𒅆𒌨	STB
𒁹𒀀𒀜𒁺𒈪𒂖𒋼𒆪𒉏𒈪	MPB
𒊹𒋡𒃻𒈨𒌍𒇻𒆰𒀀𒄯	NEB
𒀭𒀯𒄿𒆪𒌋𒀸𒃷𒋗	SUX
𒌑𒋛𒊺𒅁𒇽𒊕𒈨𒌍𒋙	NEA
𒀀𒈾𒈗𒁁𒇷𒅀𒅇𒌅𒍝𒂟𒈨𒌍	MPB
𒂗𒉣𒅀𒀀𒁺𒀠𒀭𒈨𒌍𒉌	NEA
𒁹𒊭𒈠𒂊𒊭𒀭𒂗𒆤𒌉𒊩𒃮𒌉𒊩𒀀𒉌	OLB
𒄿𒈾𒌋𒅗𒊭𒀾𒁍𒊏𒋙𒉌	NEA
𒇻𒈨𒂊𒋾	NEA
𒊹𒁹𒀴𒂍𒊕	LTB
𒁹𒀭𒌓𒀭𒊨𒉌	OLB
𒈜𒌨𒀭𒀝𒌋𒀭𒀫𒌓𒀀𒈾	NEB
𒁹𒈗𒉿𒁲𒉡𒉽𒈨𒌍	MPB
𒀭𒂗𒍪𒁁𒂖𒉌𒉌	OLB
𒈗𒁁𒉌𒀀𒌑𒁄𒀖𒀭𒉌	NEB
𒀀𒈾𒌋𒅗𒄭𒆪𒉡𒇻𒌑𒂄𒈬	MPB
𒅆𒌓𒋾𒐊𒌌𒀾𒈪	NEB
𒆳𒈗𒂗𒅀𒀀𒈾𒊍𒍪𒌨	MPB
𒊹𒌓𒈨𒌍	NEA
𒀀𒈾𒁲𒈾𒀭𒈗𒁁𒉌𒅀	NEB
𒀜𒈬𒌑𒆠𒂊𒉡𒀸𒅟𒌦𒈨𒌍𒃻	STB
𒊭𒀀𒈾𒄞𒀳𒉌𒄑𒄣	OLB
𒊭𒆳𒍝𒇷𒉺𒀀𒀀	NEA
𒈗𒌵𒆠𒁷𒌨𒊩	STB
𒂗𒅀𒄿𒉡𒈠𒄿𒈾𒀭𒈾	MPB
𒊹𒀭𒂗𒋙𒉡𒃻	NEB
𒃻𒌉𒃻𒊹𒌑𒍑𒆠𒌑𒅎𒆳𒊏	LTB
𒋳𒈠𒆷	NEA
𒊹𒋗𒉡𒄄𒄥𒊺𒊹	SUX
𒆷𒀀𒉌𒊹𒇷𒊭	NEA
𒌑𒂵𒀭𒁮𒀀𒉌	SUX
𒀭𒋡𒀜𒈠𒄞𒋗	SUX
𒀸𒁍𒁍𒋼𒄿𒈬𒌓	NEA
𒀭𒉺𒀭𒈩	NEA
𒊹𒊩𒍑𒁇𒊕𒀸	OLB
𒃮𒁉𒋙𒌒𒁍𒄣𒄿𒊏𒍦	NEA
𒁹𒁲𒀪𒌑𒉺𒀭𒌅𒋢𒇽𒈾𒁷𒈾𒈨𒌍𒆠𒊒𒁀𒀀𒈬𒈨𒌍𒌋𒁕𒈬𒍮𒌑	LTB
𒅅𒇻𒌅𒃻𒇽	NEB
𒊹𒈬𒈨𒌍𒌀𒈨𒌍𒌉𒊩𒃻𒀸𒋗𒈫𒌉𒃻	LTB
𒆳𒋗𒌒𒌈𒉌𒄴𒌈𒆪𒀊	STB
𒀝𒂗𒌓𒈠𒃻𒌷	NEA
𒃷𒃲𒃲𒂊𒋗𒈠𒊏𒀊𒅍𒂊	SUX
𒊭𒉌𒌓𒅖𒌅𒉺𒋫𒊑	MPB
𒀀𒈾𒌓𒈬𒍝𒀀𒌓𒈾𒋗𒌑𒊹𒃻𒌓𒈬𒄑𒊒𒁀𒇽𒋋𒌑𒌓	LTB
𒌝𒈠𒆷𒀊𒀀𒉿𒀴𒅟	MPB
𒀀𒈾𒅀𒀀𒅆𒆠𒀀𒈠𒀭𒁁𒇷	MPB
𒋭𒉌𒈨𒌍𒍣𒅔𒍝𒊒𒀪𒁁𒄑𒂞	STB
𒁹𒀭𒄖𒆷𒀀𒋢𒀀𒀜	OLB
𒌦𒈨𒌍𒃻𒁷𒌁𒆠	NEB
𒐍𒉌𒃮𒀭𒂗𒆠𒂵𒆤	SUX
𒊹𒌉𒃮	OLB
𒁀𒍝𒀖𒆪	SUX
𒌉𒃻𒁹𒂍𒆳𒍝𒄫𒌉𒃻𒌋𒌉𒈨𒌍𒃻	LTB
𒊭𒅟𒅈𒉺𒌅𒋗𒉡	MPB
𒋰𒋾𒌓𒅗𒁇	SUX
𒁹𒀭𒋾𒀪𒄿𒆪𒋢𒃻𒊹𒌉𒋙𒇽𒈾𒁷	LTB
𒊩𒂼𒁕	NEB
𒌉𒊩𒃻𒈠𒆟𒂊𒋩𒌓𒈬𒉺𒋡𒊑𒀀𒈾𒌋𒅗𒄭	LTB
𒁺𒄑𒈗𒋙𒌓𒆕𒍑	STB
𒇽𒌷𒊭𒊍𒄭𒈪	MPB
𒅇𒌓𒋫𒊑𒅆𒈾𒄿𒈾	MPB
𒉡𒄭𒄊𒆳𒆳	STB
𒍢𒈾𒊓𒀀𒄷	STB
𒀴𒀭𒈾𒁉𒌝	OLB
𒉚𒂍𒌋𒆠𒊒𒁀𒀀𒈬𒈨𒌍𒌀𒈨𒌍	LTB
𒈪𒉌𒅔𒊹𒊹	SUX
𒊑𒊑𒂵	OLB
𒁹𒀭𒀝𒁷𒀉	LTB
𒊭𒄿𒁷𒀭𒈥𒌅𒋞𒆠	OLB
𒃻𒋗𒈾𒀊	OLB
𒀀𒈾𒌌	NEB
𒉿𒄿𒃻𒈗	NEB
𒂍𒀭𒈾𒁺𒊏	SUX
𒅇𒈪𒋻𒀸𒊮𒁉𒋙𒀀𒈾𒁹𒀭𒈾𒈾𒀀𒈬𒇽𒈠𒄭𒊏𒉡𒂍𒈬𒈨𒌍𒅅𒁉𒅆𒁺	LTB
𒃻𒆷𒁲𒋻𒌋𒆷𒄩𒊏𒊏𒊹𒈠𒈾𒆬𒌓𒀀𒈾𒇽𒃻𒆷𒌑𒃻𒀭𒉡𒌑	LTB
𒁺𒈨𒌍𒈗𒋙𒌓𒆕𒍑	STB
𒀸𒂍𒀀𒈮𒃶𒈾𒀾𒁀	NEB
𒄞𒈨𒌍𒇻𒀴𒈨𒌍𒀀𒈾𒀭𒌋𒄥𒊌𒁷	NEB
𒌅𒃻𒊍𒈥	STB
𒀸𒆬𒌓𒂆	SUX
𒌓𒊹𒆚𒀭𒉺𒅋𒆗𒁉𒅖	STB
𒅇𒇷𒀉𒋫𒍢	MPB
𒀀𒈾𒊏𒈠𒉌𒋙	NEB
𒀀𒈾𒁕𒈾𒀭	NEB
𒂁𒉌𒄑	SUX
𒀉𒋾𒁹𒅀𒉺𒀭𒅎𒅇𒀉𒋾𒁹𒄩	MPB
𒇽𒀊𒉣𒈾𒊭𒀭𒁕𒃶𒈠𒀭	OLB
𒃻𒆠𒂊𒂙𒈾𒉺𒀾𒉌𒄑𒊓𒁍	STB
𒊹𒇽𒋃𒀀𒃻𒀀𒀕𒆠𒌗𒇯𒌓𒊹	LTB
𒆤𒌈𒄿𒋫𒈬𒌋𒌉𒆠𒀜𒋙𒆤𒌈𒄿𒋫𒈨	STB
𒌉𒃻𒀀𒈾𒄩𒆷𒃻𒌋𒌉𒈨𒌍𒃻𒂍𒅎𒆳𒊏𒌈𒋙𒌋𒌋𒌆𒁀𒀭𒉌	LTB
𒇽𒍜𒇽𒇷𒆰𒇽𒋢𒇽	STB
𒅇𒀭𒉡𒆠𒄿𒉡𒀀𒈾𒈗𒂗𒅀	NEB
𒊹𒊹𒊹𒊹	STB
𒈨𒌍𒊺𒆰𒀸𒉺𒊏𒍣	NEA
𒆳𒃻𒄭𒀀𒀮𒃻𒅅𒆗	STB
𒀀𒈨𒌍𒀀𒃻𒅇𒁹𒀭𒈾𒈾𒀀𒈬	LTB
𒅋𒇷𒄰	OLB
𒊭𒀀𒈾𒀴𒀭𒂗𒍪𒄖𒌅𒌝𒆠	OLB
𒀀𒈾𒅀𒅆𒂄𒈬𒀀𒈾𒋀𒅀𒅇𒀀𒈾𒄩𒋫𒉌𒅀	MPB
𒀀𒃻𒀀𒃻𒊹	LTB
𒊭𒀯𒊕𒈨𒃻𒃻𒇻𒀯	STB
𒇷𒅖𒈪𒁁𒇷𒅀	MPB
𒄷𒌒𒋾𒀸𒆳𒄿𒌋𒌋𒁺	STB
𒀸𒉺𒉌𒅟𒉌𒊹𒂗𒆷𒋫𒆗𒆷𒈠𒀀𒅈𒌓𒀀𒈾	NEA
𒀭𒅟𒄽𒈾𒋗	SUX
𒌓𒈬𒁕𒉌𒉌𒇷	SUX
𒈬𒋾𒈪𒈾𒄿𒈾𒆠𒊑𒅁𒌷𒀝𒂵𒋾𒆠𒅖𒅆𒇷𒅋𒋻	STB
𒀸𒌋𒅗𒊹𒊏𒉺𒀪𒇽	NEB
𒅂𒃷𒃷𒃷𒃷𒃷𒃷𒀀𒊮𒊹	SUX
𒆠𒄿𒈬𒃻𒆳𒌵𒆠𒀸𒅆𒈗𒂗𒐊𒆷𒁀𒉡𒌑	NEB
𒑏𒑏𒑏𒑏𒋡𒋡𒍥𒁕	OLB
𒉺𒀝𒁺	OLB
𒊹𒌑𒊕𒆠𒆠𒋫𒅎𒍇𒇻𒁕𒋻𒊐𒋙𒈬𒋳	LTB
𒁀𒊑𒂵𒑏𒑏𒍥𒀀𒈾𒆠𒁉𒃻	OLB
𒍂𒈠𒀀𒀀𒀠𒌓	STB
𒅇𒈬𒋾𒀭𒁕𒃶𒉺𒊩𒍑𒁇𒈨𒌍	OLB
𒁀𒊑𒂵𒁀𒊑𒂵𒁀𒊑𒂵𒁀𒊑𒂵𒑏	STB
𒋫𒋗𒉺𒇷	NEB
𒃻𒁹𒂍𒌋𒌋𒈠𒁳𒄣	STB
𒀉𒊒𒉌𒅁𒄷	STB
𒌗𒄞𒌓𒊹	LTB
𒀀𒈾𒈗𒂗𒅀	NEB
𒀀𒈾𒌓𒈬𒍝𒀀𒌓𒀉𒋫𒁷𒆬𒌓𒀀𒀭𒊹𒂆𒉚𒂍𒈬𒈨𒌍𒌀𒈨𒌍	LTB
𒌓𒀭𒆕	SUX
𒀭𒂵𒆥𒅎𒈮𒋗	SUX
𒊩𒈠𒃮𒁉𒃻𒀀𒈾𒄑𒊒𒁀𒈨𒌍𒈬𒈨𒌍𒅅𒁉𒅆𒁺𒃻𒆠𒇽𒋀𒈨𒌍𒋙	LTB
𒀭𒆥𒄖𒌋𒌗𒁈𒃻𒊹𒌋𒊹𒌓𒊹𒀯𒇽𒂠𒂷𒅆𒇲	STB
𒀀𒂵𒀀𒀀𒃻𒊹𒀸𒅎𒁾𒆠𒇴𒀀𒈾𒆕𒌍𒍢𒁍𒌓𒊏𒌋𒌋𒉡𒋙	LTB
𒀀𒀀𒄿𒁲𒅔𒆪𒉡𒉌𒀸𒅆𒊹𒈨𒌍𒆪𒉡𒇷𒅆𒈠	STB
𒈗𒆧𒆳𒈗𒆳𒆳𒁁𒉌𒐊	NEB
𒃻𒌋𒌋𒈠𒀀𒀸𒌋𒅗𒌑𒇻𒇻𒀭𒊹𒋡𒁉	STB
𒄿𒁲𒉡𒌋𒈗𒂗𒅅𒁍𒌑	NEB
𒈗𒋗𒌓𒂊𒋼𒁍𒍑	MPB
𒂟𒈨𒌍𒁉𒋫𒋫	MPB
𒀀𒁹𒀭	LTB
𒅆𒄭𒄩𒈬𒃮	SUX
𒊭𒀸𒊮𒁉	NEA
𒀀𒈾𒇽𒆗𒁲𒌑𒊑𒁺𒉌𒋀𒈨𒌍𒃻𒈗𒆳𒉏𒆠	NEB
𒊭𒀉𒋾𒁹𒀴𒌅𒌅𒌒𒆠	OLB
𒂗𒀀𒁲𒂊𒃻𒈗𒀀𒈾𒆪𒀀𒈾𒀀𒆳	NEB
𒀀𒈾𒀭𒈥𒌅𒈾𒍢𒅕	OLB
𒅇𒈠𒈝	SUX
𒀀𒀀𒈾𒌓𒈬𒍝𒀀𒌈𒀉𒋫𒁷𒆬𒌓𒀀𒀭𒑚𒈠𒈾	LTB
𒁹𒌉𒊩𒀹𒁯	OLB
𒀀𒈾𒀊𒉿𒇻𒊺𒍮𒌑	NEB
𒊹𒇽𒀀𒋛𒀸𒀀𒈾𒂍𒁓𒊕	OLB
𒄿𒃮𒁉𒌑	NEA
𒀭𒋙𒌑𒁕	STB
𒄿𒈾𒀀𒇷𒆪𒊹𒁁𒅕𒀭𒆬𒁁𒌅𒊺𒅆𒅁	STB
𒀀𒈾𒂗𒅀𒅇𒋾𒋡𒁍𒀀𒈾𒈪𒉌	MPB
𒀴𒅟𒀀𒈾𒄊𒈨𒌍𒈗𒊑	MPB
𒇷𒈬𒃶𒋻	SUX
𒀭𒀫𒌓𒈬𒊭𒅆𒌗𒆥𒀭𒈹𒌓𒊹	OLB
𒁕𒂍𒌉𒈨𒌍𒃻𒌉𒃻𒊹𒊩𒋙𒌑𒅎𒆳𒊏𒁕	LTB
𒇽𒈨𒌍𒈥𒍝𒀀𒀭𒉌𒈾	MPB
𒌉𒊹𒀭𒉺𒊑𒂊𒅆	NEA
𒄑𒆕𒋧𒇥	SUX
𒋳𒈠𒆷𒀀𒈾𒍝𒅈	MPB
𒁹𒅋𒋫𒉌	OLB
𒄶𒊹𒊹𒊹𒊹𒊹𒊹𒃷𒀀𒊮𒊹	SUX
𒈬𒁺𒀀𒈾𒀭𒂗𒍪𒊺𒈪	OLB
𒀸𒊮𒋙𒁺𒀖𒄞𒄭𒀀𒃻𒆳𒋛𒁲	STB
𒀀𒁉𒂍	SUX
𒄿𒋡𒁉𒈠𒀀𒀀𒋫𒀀	NEA
𒌦𒈨𒌍	STB
𒊭𒀠𒆷𒀜𒀭𒁕𒃶𒈠𒀭𒆜𒊹	OLB
𒄈𒋗𒄿	SUX
𒄑𒊒𒁀𒈨𒌍𒈬𒈨𒌍𒌀𒈨𒌍	LTB
𒊹𒀸𒌗𒀳𒀭𒅎𒅗𒋙𒊒𒁲𒈠𒌓𒈬𒋙𒌒𒀭𒋩	STB
𒄿𒊬𒋾𒄑𒄖𒍝𒌑𒁕𒊒𒌑	NEB
𒆳𒅇𒂵𒄠𒊏𒀜	MPB
𒌅𒌓𒊏𒌒	STB
𒀀𒆳𒃻𒈗	NEB
𒄷𒌔𒉡𒊑𒆠	SUX
𒌆𒄷𒍝𒀭𒌈𒌆𒍮𒉻𒌈𒋆𒈨𒌍𒌋𒄑𒈨𒌍𒊹𒀸𒍜	LTB
𒌓𒊹𒆚𒃻𒌗𒉈𒇽𒀀𒆥𒋙𒀀𒈾𒌋𒅗𒈪𒄑𒊒	NEB
𒅇𒋳𒈠𒁕𒈪𒅅	MPB
𒊕𒆠𒀭𒋫𒅎𒈥𒌅𒁕𒋻𒊐𒋙𒈬𒋳𒀭𒈨𒌍𒌋𒈗𒈬𒍮𒌑	LTB
𒄿𒉺𒆥𒉌𒌓𒅟𒈠𒀀𒆰𒇽𒌑𒌓	NEA
𒁍𒌑𒄿𒅟𒈾𒊮𒆳𒄭𒂵	STB
𒀭𒊕𒀭𒆗𒈾	SUX
𒂵𒈪𒅕𒇻𒁕𒀭𒈾𒅇𒆠𒄿𒋗𒉡𒋾	MPB
𒌌𒌓𒄴𒋻𒍮	STB
𒀠𒋰𒊏𒈗𒄿𒁲𒆳𒆳	NEB
𒉌𒈠𒀀𒉠𒈨𒌍𒊭𒌷𒈨𒌍𒉌𒋙𒃮𒁍𒈠	NEA
𒈥𒁲𒋾𒊭𒉺𒀠	NEA
𒌋𒌉𒈨𒌍𒃻𒀀𒇽𒈾𒁷𒈨𒌍	LTB
𒄑𒋛𒂊𒋙	NEA
𒊹𒈦𒁕𒆠𒊒𒁀𒀀𒃻𒀀𒃻	LTB
𒅇𒀀𒄯𒈪𒋀𒅀	MPB
𒊹𒀯𒊕𒈨𒃻𒀸𒌗𒀳𒅆	STB
𒀭𒈗𒉪𒀭𒈾𒈛𒀭𒂄𒉺𒌓𒁺𒆤	SUX
𒀉𒀭𒀏𒋫	SUX
𒊭𒇷𒅁𒄷𒌨𒀀𒇷	OLB
𒊭𒈗𒁁𒉌𒅖𒁓𒀭𒉌𒈠𒀀𒊺𒅔𒉡	NEA
𒀀𒁁𒁁𒈠	STB
𒅇𒉌𒌋	SUX
𒈗𒇺𒀪𒀠𒇻𒍢𒍢	NEA
𒌨𒀭𒊹𒃡𒊏	SUX
𒅇𒁕𒈨𒈨𒌍	OLB
𒀀𒈾𒁷𒌁𒆠𒀠𒆷𒅟𒁳𒁉𒈠𒀪𒁺𒋾	NEA
𒊏𒇽𒈾𒋛𒅟𒀀𒉌	NEA
𒋗𒁹𒊏𒁀𒈾𒌉𒋗𒈨𒅀𒈾𒀴𒀭𒈬𒁉𒀠𒌀𒅆𒃸	MPB
𒊹𒊩𒊮𒄞𒋛	OLB
𒂗𒌦𒈨𒌍𒋫𒁕𒀀𒉌	NEA
𒀭𒂼𒄭𒁁	SUX
𒂍𒋾𒊏𒀾	SUX
𒌓𒊬𒈬	SUX
𒄀𒌋𒄭𒃻𒄑𒆪𒋙𒀀𒁍𒁍𒄑𒍪𒋼𒆕𒆪𒃻𒋗𒈫𒀭𒀫𒌓𒃵𒇻	STB
𒀀𒉡𒌅𒄠𒈥𒀸𒊮𒁉	NEA
𒆠𒄿𒄿𒈾𒉺𒀭	NEB
𒌉𒊩𒈨𒌍𒆪𒉡𒀸𒋗𒊹𒇽𒉽𒆪𒉡𒈾𒊍𒁉𒋫	STB
𒌑𒈥𒊩𒈠𒀀𒁲𒊹𒀀𒈾𒀀𒃻𒀀𒈾𒌓𒈬	LTB
𒊒𒊏𒀀𒉌	NEB
𒅇𒉌𒅖𒈪𒄿𒉡𒈠𒂊𒁀𒋗𒈪	MPB
𒊭𒄿𒈾𒋡𒀜𒁹𒀀	MPB
𒀭𒊩𒌆𒉖𒁮𒁉𒀭𒅎𒆤	SUX
𒅇𒁉𒆠𒈪	MPB
𒀀𒈾𒁷	NEA
𒌅𒊕𒉻	STB
𒀀𒈾𒌉𒈗	NEA
𒌓𒈬𒉺𒋡𒊑𒀀𒈾𒌋𒅗𒄭𒂍𒈬𒈨𒌍𒀉𒋰𒋗𒌑𒊹	LTB
𒉺𒉌𒊭𒈗	NEA
𒆠𒊒𒁀𒀀𒈬𒈨𒌍𒀀𒈾𒁹𒈪𒅔𒀭𒈾𒈾𒀀𒀀𒈾𒌓𒈬𒍝𒀀𒌓𒈾𒋗𒌑	LTB
𒀀𒀭𒈨𒌍𒅅𒈨𒌍	STB
𒌉𒆷𒆠𒋫𒊑𒈨𒉌	OLB
𒉻𒄭𒀀𒋙𒃻𒊹𒄥𒊺𒁇𒊹𒄥𒅗𒈝𒈠𒅇𒊹𒈠𒈾𒋝𒄭𒀀	LTB
𒀀𒈾𒆳𒈪𒄑𒊑𒅇	MPB
𒀭𒂍𒀀𒐏𒊭𒈾𒁀𒆪𒀭𒂍𒀀	STB
𒊺𒁉𒀠𒉘𒂊	SUX
𒇸𒋫𒊍𒋛𒈠𒅇𒀀𒈠𒋾𒋗𒇷𒅖𒈨𒅇𒀀𒉡𒌝𒈠	MPB
𒊹𒀸𒍜𒁀𒊩𒌋𒁄𒂅𒃻𒀸𒌓𒊹𒀀𒈾𒍎𒃻𒀭𒈹	LTB
𒆠𒉌𒉌𒈠𒀀𒁉	OLB
𒀭𒂗𒁕𒇇𒈠	SUX
𒋀𒈨𒌍𒅀𒌉𒈨𒌍𒅀𒀴𒈨𒌍𒅟	MPB
𒁹𒁹𒁯𒂗𒉆𒈬𒉌𒅎	SUX
𒀲𒆪𒁺𒉡𒋫𒋫𒈾	NEA
𒀠𒇻𒌑𒆷𒀀𒋾𒇷𒌑𒈾	MPB
𒉎𒈬𒉌𒌇	SUX
𒌓𒅓𒀀𒀭𒊺𒆷𒁀𒄯	SUX
𒅟𒄀𒈾𒊮𒁉𒆳𒄭𒂵	STB
𒇻𒉌𒋛𒋙𒉡𒋾	NEB
𒄴𒆷𒈠𒅀	OLB
𒀭𒂗𒌋𒀭𒀝	NEB
𒈠𒀀𒆠	MPB
𒀸𒊑𒂍𒌷𒀸𒋩𒇷𒅔𒁕𒃻𒊒	STB
𒁹𒈪𒉌𒀭𒅎	OLB
𒊹𒀀𒈥𒌈𒈨𒌍𒈬𒈨𒌍𒄿𒅘𒃼𒋼𒀖𒌈	LTB
𒈦𒁇𒌆	SUX
𒊹𒀭𒂗𒁀𒃻𒌉𒊹𒁍𒈾𒉡	NEB
𒌋𒈨𒌍𒀀𒈾𒌉𒃻𒀀	LTB
𒈗𒇺𒀠𒋗𒌓𒍢𒃻𒀸𒁾𒊬𒌑𒌅	NEB
𒀴𒋗𒅀𒆪𒂊𒈬𒆠	MPB
𒆧𒋗𒌓𒆕𒈠	STB
𒊹𒊹𒉣𒇬𒆸𒈠𒀯𒌑𒀫𒋾𒀸𒊮𒋙𒁺	STB
𒌌𒀝𒋗𒁺	NEB
𒁀𒊑𒂵𒑏𒑏	STB
𒀀𒄷𒊻𒈠𒍑	NEB
𒅁𒋫𒀝𒁺	NEA
𒀜𒋫𒅘𒅟	NEB
𒇽𒈬𒋾𒀀𒁀𒀠𒆠	OLB
𒊹𒊹𒌓𒊹𒆚𒅆𒅟𒄀𒈾𒊮𒆳𒄭	STB
𒀀𒁲𒊹𒀀𒈾𒊩𒀭𒋾𒀪𒄿𒆠𒋢	LTB
𒊮𒊹𒇽𒀀𒋛𒊒𒌑	OLB
𒄿𒈾𒋡𒋾𒋗𒉡𒀀𒈾𒅀𒅆	MPB
𒉺𒈥𒌅𒇽𒆠𒋩𒊏𒆠	OLB
𒀀𒈾𒁓𒊕𒅔𒈾𒀜𒉡	OLB
𒌅𒊹𒋙𒊹𒋙𒄿𒁍𒋗	NEB
𒉽𒊹𒄩𒀭𒍣𒋙𒉡𒃻𒍜𒄭𒀀𒈬𒈨𒌍𒄑𒊒𒁀𒋙𒈪𒋻𒀸𒍜𒌫𒋫𒇻𒃢	LTB
𒀭𒀀𒀭𒊩𒌆𒋚𒈛𒁲𒁉𒊑𒁕𒆤	SUX
𒌉𒆰𒀕𒆠𒊏	SUX
𒁹𒆳𒉏𒈠𒆠𒅟	NEB
𒊹𒀯𒁹𒅆𒊹𒋼𒈠𒁺𒄑	STB
𒌝𒈠𒁹𒅆𒅁𒋼𒀭𒅎𒇽𒌷𒆷𒆠𒊭𒆠	MPB
𒁹𒅁𒉌𒀭𒅎𒇽𒄿𒋛𒅔𒆠	OLB
𒌗𒃶𒃶𒌓𒁺𒌓𒊹	OLB
𒌆𒈤𒌝𒈾𒀠𒁀𒅆	STB
𒈗𒆷𒄿𒈤𒄩𒊒	NEB
𒄿𒄩𒊍𒊓𒋢𒄷𒌓𒊮𒌦𒈨𒌍𒃻𒀭	STB
𒀭𒀸𒁽𒌓𒊏	SUX
𒌉𒃻𒌉𒃻𒇽𒂊𒄫𒌋𒌆𒇻𒅎𒄭𒀀	LTB
𒊹𒁕𒂍𒁹𒀭𒈾𒈾𒀀𒈬𒌋𒋀𒈨𒌍𒋙𒌉𒈨𒌍𒃻𒊹	LTB
𒀭𒀭𒋫𒋩𒊏	SUX
𒀀𒁹𒆳𒄿𒅇𒁕𒂍𒋗𒈫𒃻𒊹𒀀𒃻	LTB
𒀀𒈾𒌓𒈬𒍝𒀀𒌓𒀉𒋫𒁷𒆬𒌓𒀀𒀭𒑛𒈠𒈾	LTB
𒁹𒋀𒀪𒌑𒌅𒀀𒃻	LTB
𒁹𒀀𒋾𒂊𒉌𒌑𒉡𒌋𒇽𒋀𒈨𒌍𒋙𒈬𒈨𒌍𒀀𒈾𒀀𒃻𒀀𒈾	LTB
𒆳𒂗𒂖	STB
𒅖𒋫𒃶𒉡𒌋𒋀𒋙𒌉𒃻𒌉𒃻	LTB
𒋫𒁀𒅆𒅋𒁹𒁕𒀊𒋾	STB
𒊹𒈦𒂆𒆬𒌓𒄑𒋫𒌁𒊏𒉡𒃻𒁹𒀭𒋾𒀪𒆪𒋢𒉽𒁀𒉡𒌑𒌓𒀀𒈾𒉚	LTB
𒌋𒀸𒀸𒀸𒀸𒀸𒀸𒄥𒊺𒊹	SUX
𒂗𒅀𒈪𒅎𒈠𒀀𒄿𒈾𒍜𒊮𒂗𒅀	MPB
𒊿𒅟𒈠𒀀	NEA
𒄈𒂊𒈾𒆕	SUX
𒌉𒊩𒈨𒌍𒆪𒉡𒋫𒆳𒇷𒄴𒇷𒅅	STB
𒂟𒈨𒌍𒅟𒊭𒊭𒅕𒁍𒉏	MPB
𒀭𒀀𒊏𒍪𒈫	SUX
𒊩𒄸𒀠𒁆	SUX
𒊭𒅖𒌅𒈾𒄰𒌈	OLB
𒊹𒊕𒊩𒆳𒈨𒌍	OLB
𒌦𒋡𒁹𒁀𒆷𒂅	LTB
𒀸𒋗𒊹𒋙𒉡𒇻	NEB
𒋾𒆷𒋢	STB
𒄑𒈾𒁀𒉌𒊑𒊑	SUX
𒃻𒇽𒀀𒆥	NEB
𒋃𒀭𒊩𒌆𒃲	SUX
𒌓𒄰𒀸𒅆𒀭𒀫𒌓	STB
𒌒𒇴𒇽𒉌𒋛𒅔𒆠	OLB
𒀀𒆳𒋼𒊺𒂊𒀸𒆳𒃮𒌒𒁹𒆳𒅆𒂟	STB
𒁹𒄿𒋫𒈾𒄴𒀭𒁺𒃮	OLB
𒀀𒃻𒃻𒋫𒇽𒉺𒇻𒈨𒌍𒃻𒂍𒀭𒈨𒌍𒃻𒀕𒆠𒀀𒈾𒌓𒈬𒍝𒀀𒌓𒋗𒌑	LTB
𒃼𒊏𒁺𒌝	OLB
𒀭𒊩𒌆𒉈𒊬𒀀	SUX
𒃻𒌋𒌉𒈨𒌍𒃻	LTB
𒀸𒇻𒉌	SUX
𒊹𒀀𒊑𒄭	NEA
𒊹𒂊𒄈𒀀𒋾𒀸𒌋𒅗𒂗𒐊	NEA
𒀭𒂗𒀭𒀝𒌋𒀭𒌓𒀀𒈾𒈗𒁁𒉌𒅀𒌨𒊒𒁍	NEB
𒌉𒀭𒊩𒌆	OLB
𒃻𒈗𒁁𒉌	NEB
𒈗𒂗𒅀	NEA
𒀀𒈾𒆬𒌓𒀀𒈾𒊑𒄷𒄭𒀀𒈾𒉡𒂄𒉡𒌑𒂊𒄫𒍮𒁍𒌑𒌓𒌋𒀀𒈾	LTB
𒄷𒌓𒊮𒂟𒈨𒌍𒊮𒈗𒄭𒂵𒀊	STB
𒊭𒉌𒌓𒂟𒈨𒌍𒆳𒄩𒀜𒋼	MPB
𒊹𒈨𒊺𒉻𒈨𒌍𒀸𒉺𒉌𒅀𒊑𒂊𒄩𒀜	NEA
𒍝𒅈𒊒𒌓𒋾𒄿𒈾𒊮𒁉𒅟𒅇𒄿𒈾𒄩𒊍𒍣𒅔𒉌	MPB
𒀭𒈨𒌍𒉡𒅀𒅇𒀭𒌓𒈨𒌍	MPB
𒇽𒈬𒈥𒋡𒀭𒉡	LTB
𒁹𒉌𒉌𒂊𒋫𒀜𒁲𒀭𒉌	OLB
𒀭𒂗𒍪𒄿𒁷𒉆	OLB
𒀭𒀖𒃸𒈫	SUX
𒉏𒈠𒆠𒇽𒉽	STB
𒄷𒄭𒀀𒃻𒀸𒌓𒊹𒃻𒌗𒊺𒀀𒈾𒄑𒍎𒃻𒀭𒌈𒇯𒁺𒌑𒀸𒍜	LTB
𒂟𒈨𒌍𒅀𒀜𒌅𒉡𒀀𒁺𒌑𒇽𒀀𒆥	NEB
𒁕𒃻𒁹𒀭𒈹𒈬𒆚𒇽𒋙𒉡𒀀𒃻	LTB
𒋗𒀭𒅎𒈠𒌨𒌉𒀭𒅎𒌨𒊕	MPB
𒅇𒀭𒀫𒌓𒈾𒍢𒅕	OLB
𒀀𒋫𒄯𒅅𒄭𒁉𒌑𒈠𒀀𒊑𒄴𒋼	NEA
𒀭𒂼𒍪𒀭𒊩𒌆𒄢𒈾𒂼𒃶𒆰𒍣𒁕	SUX
𒆠𒈠𒅈𒄭𒅖𒀀𒉡𒈠𒆠𒀀𒈠	MPB
𒀀𒉡𒌓𒊭𒊹𒌝𒁀𒆠𒁲𒉌	NEA
𒁮𒈬𒅔𒉡	SUX
𒌑𒆷𒀀𒄿𒋛𒅀	NEA
𒌅𒍝𒀪𒊍	STB
𒀸𒌋𒅗𒐊𒌌𒋻𒊑𒄷	NEB
𒊹𒀭𒊹𒉣𒇬𒆸𒆸𒈠𒊹𒀯𒈨𒌍	STB
𒀀𒈾𒆳𒆠𒈾𒄴𒄭𒆏𒉺𒊭𒆠𒄿𒄿𒊏𒌑𒌒	MPB
𒀀𒈾𒂍𒀀𒋛𒀸𒄿𒌅𒊏𒄠	OLB
𒊭𒄿𒇻𒉌𒉺𒋼𒋛𒇽𒀊𒉣𒈾𒆠	OLB
𒅕𒍢𒅀	OLB
𒌦𒈨𒌍𒋙𒉡𒊭	NEA
𒀀𒈾𒌷𒀏𒆠	NEA
𒀀𒊹𒌑𒊕𒆠𒆠𒋫𒅎𒆳𒊏𒁕𒂍	LTB
𒌑𒊓𒀠𒁉	NEA
𒃻𒀭𒂍𒀀𒄿𒁀𒀾𒅆	NEA
𒄿𒉡𒈠𒂊𒌀𒅗𒀭𒌓𒊭𒀊𒀸	OLB
𒇽𒁺𒌦𒉡𒌝𒆠	OLB
𒌋𒃷𒃷𒃷𒃷𒈦𒃷𒁹𒁹𒁹𒁹𒁹𒁹𒊬𒋞𒍝𒌷𒅔𒆠𒁲𒀀𒃴𒁉𒁹𒁹𒁹𒌑	SUX
𒈨𒌍𒉺𒅆𒌈𒃻𒂍𒈬𒈨𒌍𒈨𒌍𒉺𒈬𒈨𒌍	LTB
𒇽𒊩𒋢𒊹𒂗𒊭𒆏𒀸𒊮𒁉𒋙𒉡𒈗𒁁𒉌	NEA
𒁹𒅖𒁯𒈠𒄀𒊏𒀜	OLB
𒅀𒁲𒉡𒂗𒇷𒀀𒈾𒀴𒀭𒅎	MPB
𒋫𒇻𒀴𒃻𒀸𒌓𒊹𒀀𒈾𒄑𒍎𒃻𒀭𒃽𒂔𒇯𒁺𒌑𒄑𒊒𒁀𒋙𒃻𒍜𒁀𒀾𒇻	LTB
𒁾𒊬𒁶𒊑𒈬𒋙𒈜𒅆𒀉	STB
𒊹𒊹𒆳𒈠𒀭𒌑𒄿𒋛𒈬𒈬𒈨𒌍	STB
𒈨𒈨𒉌𒀸𒆪𒊑𒇷𒅀𒆷𒀾𒋙	NEA
𒀀𒃻𒀀𒀀𒃻𒀀𒃻	LTB
𒀀𒈨𒇻𒋗𒌋𒊹𒈬𒀭𒈾𒈨𒌍	STB
𒀀𒈾𒈗𒁁𒇷𒅀𒀭𒌓𒅀	MPB
𒂗𒅀𒊹𒊹𒄠𒆪𒌓𒀸𒋫𒁇𒀀𒈾	MPB
𒄩𒆷𒋙𒉡𒃻𒀸𒊺𒆰𒈬𒈨𒌍𒌋𒋗𒁁𒌷𒈬𒈨𒌍𒌋𒌉𒈨𒌍𒃻𒈾𒋗𒌑	LTB
𒆠𒁲𒉡𒊻𒋛𒈾𒀉𒋾𒉌𒈠𒇻𒅟𒊍𒋥	NEB
𒈗𒋙𒌓𒆕𒍑	STB
𒋀𒀭𒁕𒃶𒈠𒀭	OLB
𒁉𒈨𒌍𒅇𒀸𒋳𒈠	MPB
𒄑𒍣𒄑𒈗𒆳𒀸𒆤𒋾𒋙	STB
𒀀𒈾𒈗𒁁𒇷𒅀𒅁	MPB
𒀀𒈾𒀀𒈾𒌓𒈬𒍝𒀀𒌓𒈾𒋗𒌑𒂍𒌋𒆠𒊒𒁀𒀀𒈬𒈨𒌍	LTB
𒀭𒈪𒆳𒆳	STB
𒁉𒌦𒈨𒌍𒋙	NEA
𒇷𒄑𒊓𒃶	NEA
𒀭𒉌𒈗𒄿𒁲	NEB
𒊹𒌉𒊏𒈗𒀭𒌓	OLB
𒁁𒂖𒋗𒉡𒉺𒀀𒋛𒀸	OLB
𒈗𒉢𒁓𒆷	SUX
𒆳𒄑𒂞𒈾𒇽𒉡𒆭𒆭𒁕	SUX
𒊭𒉌𒉌𒅀𒉺	OLB
𒊭𒋼𒀀𒈬𒉌𒃻𒋃𒈨𒌍𒀭𒉡𒋼𒌑𒊩𒇴	NEA
𒊹𒇽𒋃𒌉𒃻𒀀	LTB
𒇻𒌋𒁲𒈬𒀀𒈾𒈗𒆳𒆳𒂗𒅀	NEB
𒄠𒆪𒌓𒊹𒅇𒊹	MPB
𒀸𒉺𒉌𒂊	NEA
𒋗𒆸𒆸𒍑𒅇𒊕𒆠𒈪𒋚𒌈𒂍𒌋𒆠𒊒𒁀𒀀𒈬𒈨𒌍	LTB
𒈨𒆬𒌓𒈨𒌍	NEA
𒀀𒊮𒈨𒌍𒄑𒊬𒈨𒌍𒌦𒈨𒌍𒌑𒊓𒊍𒂍	NEA
𒅇𒅅𒋫𒁍𒌑𒄿𒈾𒆳𒈪𒄑𒊑𒅎𒈠𒀀𒈨𒆬𒄀𒂖𒂊𒁉𒊑𒈠𒀀𒋫𒀜	MPB
𒂗𒈾𒅇𒈪𒈾𒄠	MPB
𒀀𒇉𒊊𒂔𒈾	SUX
𒀀𒈾𒆷𒆷𒌈𒂼𒈗	OLB
𒀀𒄭𒀀𒄭𒅀	MPB
𒌑𒁀𒆷𒀸𒄩𒊏𒄠𒈨	NEA
𒊭𒍝𒇻𒄷𒌝	OLB
𒄿𒍣𒅕	NEB
𒀀𒁲𒊹𒀀𒈾𒊹𒀀𒈾𒌓𒈬𒍝𒀀𒌓𒄿𒉆𒁷𒁍𒌓𒀀𒄩𒀀𒈩	LTB
𒀀𒈾𒂗𒆪𒉡𒋫𒃮𒁉𒀀	NEA
𒌑𒋼𒊒𒉌𒋗𒉡𒋾	OLB
𒈦𒂆𒈬𒈨𒌍	LTB
𒀭𒅟𒅟𒆷𒆯𒋗	SUX
𒀸𒉺𒉌𒉌𒄿𒋛𒋛𒌑𒅇𒊹𒁀𒆷𒋢	NEA
𒁹𒀴𒀭𒍝𒂷𒂷𒋞𒆠	OLB
𒄩𒀀𒆠	SUX
𒀀𒀀𒌉𒃻𒀀𒀀	LTB
𒀀𒉿𒋼𒈨𒌍𒁾𒁉𒅀𒅇𒇽𒌉𒆥𒅀	MPB
𒀭𒄑𒉢𒈬𒁺𒅅𒋫𒁀𒀾𒋙𒉡𒌓	NEB
𒈪𒉡𒌑	NEB
𒉆𒄩𒅈𒋾𒁹𒀭𒉌𒉌	OLB
𒌌𒀀𒄯𒄿𒈾𒉺𒀭	NEB
𒀀𒊭𒊑𒁺	MPB
𒈠𒀀𒀀𒌨𒌒𒌓𒇽𒌀𒈨𒌍	NEA
𒊭𒀭𒅗𒀭𒌓𒉺𒋼𒋛	OLB
𒉺𒊑𒌈𒋻𒆷𒌈	STB
𒀀𒃻𒋀𒋙𒀀𒃻𒀀𒈨𒌍𒃻𒂍𒌈𒋙	LTB
𒌅𒈾𒀪𒀀𒋙𒉡	STB
𒀀𒈾𒂅𒌒𒈠𒄩𒊏	NEB
𒄑𒄀𒂗𒄀𒈬	SUX
𒀭𒆬𒆍𒀭𒊹𒊭𒌷𒃻𒂵𒈩	STB
𒅋𒇷𒆪𒉌	NEB
𒁹𒆠𒁷	LTB
𒉌𒈠𒊏	NEA
𒁉𒀉𒊒	MPB
𒆠𒄿𒉺𒀭𒇽𒃲𒊕	NEB
𒅟𒀀𒀀𒈠𒉡𒄿𒍝𒉡𒌦𒉡	NEA
𒌉𒈨𒌍𒊩𒌆𒈨𒌍𒋙𒉡𒊮𒁀𒋙𒉡	NEB
𒀀𒈾𒆪𒉡𒉽𒆗𒂵𒀀𒈾	MPB
𒈦𒅟𒀭𒋾𒉌𒌓𒍝𒆳𒈠𒈾	STB
𒍣𒍪𒀸𒈗𒀭𒈨𒌍𒀭𒊹	STB
𒁁𒉌𒅀𒌨𒊒𒁍	NEB
𒇽𒈾𒋛𒅟𒉌𒇽𒋙𒂈𒈨𒌍𒃮𒁍	NEA
𒅖𒌅𒊓𒈨𒈠	MPB
𒊹𒑛𒈠𒊹𒊺𒆬𒌓	OLB
𒈗𒁁𒉌𒀀𒅅𒋫𒁉𒌝𒈠𒅆𒉡𒌋𒈬𒃻𒀭𒄭𒍮	NEB
𒂗𒆤𒆠𒆠𒈠𒁷𒌁𒆠𒀪𒀀𒆪𒂄𒁍𒌓𒅇𒁀𒋳𒋙𒌌𒃻𒀊	NEB
𒈗𒀸𒌷𒉽𒋙𒆪𒀊	STB
𒃻𒀀𒋙𒀀𒁲𒀲𒃵𒂷𒋙	NEA
𒅇𒆠𒈾𒈾𒁕𒀭𒉡	MPB
𒀉𒋫𒈾𒆷𒆪	MPB
𒄩𒀭𒍪𒃻𒌓𒈬𒊩𒋙𒀸𒊹𒃻𒌓𒈬𒀸𒌓𒊹𒌓𒊹𒅇𒌓𒊹𒄑𒊒𒁀𒋙	LTB
𒈬𒂊𒉌𒅆𒊒𒁕	SUX
𒌋𒀭𒊺𒉀	MPB
𒀭𒀊𒈤𒀭𒌓	SUX
𒃻𒌗𒀳𒀀𒈾𒊮𒁉𒆠𒄿	NEB
𒅖𒁓𒌋𒉌𒈗𒁁𒉌𒀸𒌋𒅗	NEA
𒌗𒀀𒌓𒊹	OLB
𒇽𒁾𒊬𒇽𒄬	MPB
𒄊𒀭𒀫𒌓𒈾𒍢𒅕	OLB
𒌝𒈠𒁹𒀀𒈠𒉿𒊺	MPB
𒅅𒋫𒆳𒋢𒊬𒅟𒃻𒁺	STB
𒉽𒊹𒈨𒊹𒇽𒂟𒈨𒌍	NEA
𒉡𒌑𒂗𒈾	NEB
𒀭𒊕𒈨𒃻𒀸𒈬𒋙𒈾𒁷𒀉𒋾𒁹𒆳𒆳𒃻𒌋𒌋𒈾𒁷	STB
𒇡𒊏𒀀𒋾𒆠𒈫𒁉𒊏𒀀𒋾	STB
𒊭𒋗𒌑𒌋𒉺𒀀𒊏𒅋𒁕𒈾𒊍	MPB
𒆤𒈬𒊑	NEA
𒁹𒈠𒀜𒋫𒌈𒌉𒊩𒃮𒌉𒊩𒀀𒉌	OLB
𒄑𒆵𒆠	SUX
𒆠𒈫𒆠𒄿𒃻𒈲𒅇𒀭𒊩𒌆𒉾𒀸𒊮𒁉𒊹𒀉𒄷𒊑𒋾	STB
𒊩𒈠𒀸𒊮𒁉𒆷𒅋𒆷𒀀𒆷	STB
𒉡𒉌𒀀𒁀𒅈𒋫𒄠𒋫𒄿𒈾𒈪𒊺𒇷𒅔𒅆𒅋𒈠	STB
𒁹𒀀𒈾𒀭𒌓𒁖𒆷𒆪𒊹𒊕𒀴𒈨𒌍	OLB
𒀸𒋢𒀪𒇷	STB
𒃻𒌗𒊻𒋢𒆗𒈬𒀭𒈾𒄖𒊌𒋡𒉌𒂊	LTB
𒊭𒀀𒈾𒁁𒂖𒋗𒉡	OLB
𒇽𒄩𒍝𒉡𒊭𒌷𒍣𒁺𒈾𒆠	MPB
𒂍𒉺𒂍𒌒𒅓	SUX
𒀭𒈪𒍑𒋰𒋗	SUX
𒀀𒈾𒋫𒈥𒋾𒈗𒋾𒅀𒆠𒆗	STB
𒂙𒆳𒈥𒌅𒆠𒋛𒁲	STB
𒀀𒈾𒌋𒅗𒄭𒉌𒅋𒇷𒆪𒉌𒈠𒄀𒅖𒊒	NEB
𒀭𒊹𒁉	STB
𒆕𒍝𒃮𒈾𒁉𒂼𒋙𒄿𒊩𒌨𒅴𒋙	STB
𒁈𒀭𒌓𒅟	SUX
𒀸𒈪𒋻𒇻𒀴𒃻𒀸𒌓𒀊𒀊𒈨𒌍𒃮𒁉𒃻𒀀𒈾𒄑𒍎𒃻𒍝𒇴𒈗𒈨𒌍𒇯𒁺𒌑	LTB
𒅇𒀀𒉡𒈠𒀀𒍣𒊒𒊹𒌗𒄭𒈨𒌍	MPB
𒌋𒁕𒈬𒍮𒌑𒃻𒌉𒃻𒄿𒋺𒁲𒆗𒊹𒌑𒍑	LTB
𒊹𒀭𒀸𒁁𒀸𒌗	STB
𒉺𒉌𒃻𒈗𒁁𒉌𒅀𒇻𒄯𒈠	NEB
𒊹𒊩𒌉𒊏	OLB
𒈪𒄴𒍣𒀀𒉌𒁲	NEA
𒀴𒋗𒅇𒋡𒁉𒋾	MPB
𒉽𒊹𒈨𒌍𒉺𒃻𒂍𒉣𒇬𒌋𒆠𒊒𒁀𒀀𒈬𒈨𒌍𒂍𒉣𒇬𒌋𒆠𒊒𒁀𒀀𒈬𒈨𒌍	LTB
𒆠𒊒𒁀𒀀𒈬𒈨𒌍𒀉𒋰𒋗𒌑𒌋𒌉𒈨𒌍𒃻	LTB
𒉡𒊺𒊏𒁕𒋙𒉡𒀸𒉺𒉌𒇽𒂗𒉆	NEA
𒆠𒄑𒍪𒊏𒀜𒀭𒂗𒆤𒀜𒌋𒀭𒊩𒌆𒇸𒀜	STB
𒌷𒁺𒌑𒈨𒀭𒀀𒁲𒄿	NEB
𒀭𒀝𒌋𒀭𒀫𒌓𒀀𒈾𒈗𒁁𒉌𒐊	NEB
𒀭𒂗𒆤𒀭𒈦𒌋𒀭𒉺𒌆𒁹𒈗𒆳𒆳𒂗𒐊	NEB
𒁹𒀭𒌓𒄿𒁷𒉆𒇽𒋗𒄩	OLB
𒅆𒊹𒌋𒄥𒌋𒌋𒉽𒈨𒌍𒋙	NEA
𒀀𒈨𒌍𒀉𒋾𒋙𒉡𒉌𒅋𒋾	NEB
𒇽𒉌𒋛𒅔𒆠𒈨𒌍	OLB
𒈗𒂍𒈤𒊏	SUX
𒀀𒈾𒁷𒍣𒈨𒌍𒋙𒅇𒅆𒌨𒋛𒋙𒂠𒂉𒈠𒊑𒅇	STB
𒊭𒅁𒂵𒌈	OLB
𒄩𒈬𒌑𒌋𒄿𒌋𒌋	NEB
𒃻𒀀𒈾𒄑𒊒𒁀𒇽𒆭𒂍𒌑𒌓𒈬𒈨𒌍𒅅𒁉𒅆𒁺𒃻𒆠𒋀𒈨𒌍𒋙𒅇	LTB
𒆠𒁉𒉈𒄄	SUX
𒀀𒈾𒉺𒄑𒇀𒈨𒌍𒊭	MPB
𒊹𒊮𒀜𒌅𒄢𒋾𒇷𒅁𒇻𒌓	OLB
𒅇𒂍𒆠𒊒𒁀𒀪𒈨𒌍𒃻𒀸𒆠𒁴𒂍𒀭𒅎𒃻𒆠𒆗𒀕𒆠𒊹𒌑𒍑𒀭𒌑𒅎𒋛𒁲	LTB
𒀭𒉽𒌋𒌓𒆤𒈫	SUX
𒊕𒆠𒀭𒋫𒅎𒈥𒌅𒁕𒂍𒀀𒈨𒌍𒃻𒀀𒃻	LTB
𒌨𒆬𒉣𒈾𒈛	SUX
𒀭𒊩𒌆𒅁	SUX
𒊹𒌉𒊏𒉌𒉌𒅗𒅀𒌑𒀫	OLB
𒌅𒃷𒈾𒀭	STB
𒆳𒀀𒁓𒊕𒆪𒀊𒈗𒊕𒆗𒌓𒁺𒀝	STB
𒇽𒈬𒁺𒃻𒌉𒃻	LTB
𒆠𒄿𒀭𒉌𒄿𒅅𒁲𒁉𒈠𒀀	NEA
𒈠𒀀𒆠𒊑𒅁𒀸𒅆𒀉𒊹𒂊𒀀	NEA
𒌝𒈠𒀀𒇷𒂵𒀭𒉌𒅇𒋗𒊑𒁀𒀭𒉌𒄿𒈾𒌷𒆠𒅀	MPB
𒉺𒉌𒋗𒉡𒄿𒊕𒉡𒈠𒀀	NEA
𒀭𒈬𒆸𒀀𒈨𒌍𒋾𒆷𒋗	SUX
𒀸𒄞𒄭𒀀𒃻𒀸𒌓𒊹𒀀𒈾𒍎𒃻𒀭𒌈𒇯𒁺𒌑𒄑𒊒𒁀𒈨𒌍𒈬𒈨𒌍	LTB
𒃻𒌷𒅟𒈛𒀀𒈾𒆬𒌓	NEB
𒄑𒊒𒁀𒋙𒉡𒃻𒀸𒂍𒄑𒊬𒄬𒆳𒀸𒂍𒂉𒊕𒂵𒉌𒂍𒀭𒃽𒂔	LTB
𒈗𒈠𒌷𒆠𒅟	SUX
𒁹𒄿𒋫𒉿𒅕	OLB
𒊹𒌑𒊕𒆠𒀭𒋫𒅎𒋛𒁲𒁕𒂍𒌉𒃻	LTB
𒀭𒊩𒌆𒅁𒃲𒋗	SUX
𒀕𒆠𒌗𒋗𒆚𒌓𒊹𒈬𒊹𒁹𒁲𒂊𒈪𒁲𒊑𒂊𒋢𒈗	LTB
𒋢𒄭𒅔𒌓	NEA
𒀸𒆳𒆳𒃮𒁉𒌌𒀉𒊑𒀉	NEB
𒀜𒆗𒈪𒉌𒀸𒀲𒀀𒈾𒆪𒀲𒆳𒊏𒀀𒋃𒆥𒌑𒃻𒊍𒁁	NEA
𒀸𒆳𒁇𒄩𒊍𒍣	NEB
𒁹𒁺𒌋𒁺𒅇𒇽𒈨𒌍𒃲𒁍𒋼𒈨𒌍	MPB
𒅔𒁕𒄯𒊒𒀀𒈾𒈗𒂗𒄿𒉌	NEB
𒀭𒁀𒌑𒌷𒅟𒄀𒈾𒊏𒆠𒀭𒈾𒉘𒂷𒉌𒉡𒌀𒇷	SUX
𒅇𒊹𒀀𒈾𒊹𒀀𒈾𒌓𒈬𒍝𒀀𒌓𒈾𒋗𒌑	LTB
𒊹𒇽𒈾𒁷𒈾𒀭𒂍𒅇𒌑𒉡𒌑𒌓𒂍𒈬𒈨𒌍𒌑𒈥𒊩𒆪	LTB
𒈠𒄠𒈝𒊏𒀪𒀀𒁍	STB
𒋦𒊹𒄠𒆠𒉌𒇥𒀸𒃮𒋛𒄑𒊬	NEA
𒁕𒁉𒅁𒅆𒂟𒈨𒌍	STB
𒊹𒊹𒀸𒇻𒀴𒈨𒌍𒃻𒄭𒋫𒋰𒃾𒋆𒇷𒌆𒄷𒍝𒈾𒌈	LTB
𒂍𒃲𒃮𒁉	NEB
𒌉𒊩𒃻𒊩𒆪𒆷𒀪𒀭𒀸𒁁	LTB
𒄿𒈾𒊩𒌆𒃲𒁺𒁺𒆠	OLB
𒄊𒈨𒌍𒅟𒀀𒈾𒄊𒈨𒌍𒁉	MPB
𒄿𒊑𒁀𒄠	OLB
𒊮𒇽𒀀𒋛𒀸𒊮𒊹𒀀𒋛𒊑	OLB
𒌌𒅇𒁇𒋫𒈠𒀠	NEB
𒀸𒊮𒁉𒊹𒈠𒈾𒆬𒌓	NEA
𒁹𒁕𒅈𒅖𒆠	OLB
𒄥𒊹𒑏𒊹𒋡𒅇𒈪𒋻𒊑𒁍𒌑𒄑𒊒𒁀𒈬𒈨𒌍𒃻𒀸𒅆	LTB
𒀀𒈾𒆍𒀭𒄿𒋼𒊒𒌒	NEB
𒊭𒀴𒊏𒈾𒈲	OLB
𒉡𒊌𒆷𒀾𒋙𒆷𒄿𒃻𒈬𒌋𒉌	NEA
𒌋𒁇𒁺𒃮	SUX
𒈗𒂗𒇷𒁺𒃶𒉌	NEA
𒅇𒉿𒁲𒈗𒁁𒇷	MPB
𒀭𒀀𒆷𒈛𒀭𒂗𒍪𒆤	SUX
𒊓𒀭𒋳𒄀𒉡𒌋	STB
𒅇𒀴𒊭𒅖𒈨𒀀𒈾𒂗𒋗	MPB
𒊹𒀭𒀝𒁲𒅎𒌉𒁁𒉌𒆪𒉡	NEB
𒅆𒊹𒌗𒀊𒀀𒀀	NEA
𒀀𒈾𒋫𒈥𒋾𒈗𒋾𒅀𒆠𒆗𒂍𒃲𒅀	STB
𒃻𒋗𒅎𒄥𒀭𒂗𒍪	OLB
𒀭𒅟𒁀𒉌𒁲𒈠𒋗	SUX
𒅇𒄿𒁲𒈗𒂗𒅀𒄿𒉡𒈠	MPB
𒀀𒈾𒆪𒀀𒈾𒁹𒅀𒀭𒄩𒈬	MPB
𒀖𒉺𒇻𒍣𒀭𒁹𒌉𒁹𒆳𒈠𒀭𒈪𒂗𒉣𒌓𒉌𒇷𒌑𒃵𒂇𒀭𒈪	STB
𒁕𒂍𒈗𒍢𒂊	SUX
𒌓𒈬𒍝𒀀𒌓𒈾𒋗𒌑𒃻𒂵𒊹𒂍𒈩𒋾𒃻𒀀𒃻	LTB
𒈗𒈨𒌍𒂗𒈨𒌍𒉌𒅅𒋻𒊏𒁍	NEB
𒄿𒈾𒀾𒅆𒌋𒂗𒈾	NEB
𒁀𒁀𒋾	SUX
𒃻𒉿𒅀𒈗𒇺𒈪	NEB
𒀀𒉌𒀀𒈾𒆪	NEA
𒌅𒊺𒊐	STB
𒆳𒈨𒌍𒆏𒁀𒅆𒈾	MPB
𒊹𒊹𒀜𒊕𒌓𒁺𒈠𒁶𒉈𒅎𒀭𒂊𒃻𒈗𒆳𒆳	STB
𒌅𒈠𒆠𒈠	STB
𒅇𒀭𒌓𒄿𒈾𒊭𒈨𒄿𒁀𒅆	MPB
𒁹𒋗𒋻𒈾𒀀𒁉𒅀	MPB
𒊭𒊓𒈬𒌝𒄴𒈨	OLB
𒊹𒈠𒈾𒍏𒄭𒀀𒉌𒄩𒁹𒁕𒀊𒋾𒍝𒆪𒋾	STB
𒌒𒅟𒌋𒌋𒆠𒄿	NEB
𒋾𒅋𒇷𒃻𒆬𒌓	NEB
𒀭𒁁𒀖𒀭𒈨𒌍𒂗𒆳𒀮𒉌𒋾𒋫𒀖𒌓	STB
𒇻𒈠𒊬𒈬𒄰𒊭𒀜𒁕𒀭𒉌𒁕𒀊𒁍𒈾𒈾	MPB
𒇽𒁷𒌁𒆠𒈨𒌍𒀸𒄷	NEB
𒊭𒋗𒈨𒆳𒊒𒄿𒉺𒀾𒅆𒂅𒈬𒋙	STB
𒌉𒃻𒀀𒈾𒄩𒆷𒃻𒌉𒃻𒂍𒅎𒋛𒁲𒌈𒋙𒀸𒀀𒊬𒈬𒈨𒌍𒊹𒑛𒌑	LTB
𒃲𒊹𒆬𒄀	MPB
𒀜𒋫𒈠𒀀𒌉𒆍𒀭𒊏𒆠	NEA
𒈬𒁲𒁇𒍢	MPB
𒈨𒌋𒌓𒆤𒋫	SUX
𒀀𒈾𒊭𒋗𒅇𒉺𒀸𒄩𒀜	MPB
𒂗𒇽𒋫𒁕𒉌	NEA
𒁉𒅁𒈝𒆳𒌒𒁄𒀀𒆗	STB
𒊹𒊕𒊩𒆳𒀴𒈨𒌍	OLB
𒊭𒀭𒊩𒌆𒋚𒆪𒋫𒋗	OLB
𒄑𒊒𒁀𒈬𒈨𒌍𒀉𒋰𒋗𒌑𒁹𒀭𒈾𒈾𒀀𒈬𒌉𒋙	LTB
𒀀𒈨𒇷𒂊𒋾𒅅	STB
𒀭𒊩𒌆𒆬𒄀𒁮𒁉𒀭𒂗𒆤𒇲𒆤	SUX
𒀭𒀫𒌓𒈬𒊭𒅆	OLB
𒉌𒅁𒁍𒍑𒈠𒉺𒀭𒈗	NEB
𒇽𒀀𒆥𒃻𒈗𒂗𒄿𒉌	NEB
𒈬𒈨𒌍𒊹𒌑𒊹𒁕𒂍𒄩𒆷𒃻𒊹𒌋𒋀𒈨𒌍𒋙𒌉𒈨𒌍𒃻𒊹	LTB
𒀀𒈾𒉺𒉌𒅀𒊒𒆜𒋙𒉡𒌅	NEB
𒀀𒃻𒌋𒊩𒆚𒌈𒀭𒈾𒈾𒀀𒁮𒋙𒊹𒌑𒊕𒆠𒀭𒋫𒅎𒈥𒌅	LTB
𒀀𒈾𒄊𒈨𒌍𒈗𒁁𒅀𒀭𒌓𒅀	MPB
𒈗𒆧𒋙𒌓𒆕𒍑	STB
𒀀𒈾𒌉𒃻𒀀𒋫𒉆𒁷𒁍𒌓	LTB
𒀭𒀉𒂵𒉌𒁮𒁉𒊩	SUX
𒄿𒈾𒉈𒄿𒊭𒋾𒅇𒀀𒈾𒈬𒄭	MPB
𒀸𒆍𒀭𒊏𒆠𒋙𒌑	NEB
𒁹𒀭𒌓𒈬𒉡𒌑𒍑𒆠𒌑𒅎𒍇𒇻𒁕𒂍𒅎𒆳𒊏𒄩𒆷𒃻𒊹𒈬𒈨𒌍𒁕𒋻𒋝𒈬𒋳𒌦𒈨𒌍	LTB
𒄴𒈨𒄀𒉈	SUX
𒊒𒁴𒉏𒈠𒆠𒅅𒅆	STB
𒆷𒋡𒅆𒀀𒉡𒈠𒌍𒈪𒁍𒄭𒅕𒈪	MPB
𒅆𒀉𒁍𒍮𒆗𒉌	STB
𒉌𒊓𒄷	NEA
𒅎𒈥𒌅𒁕𒂍𒁹𒀭𒈾𒈾𒀀𒈬𒋀𒋙𒌉𒈨𒌍𒃻𒊹𒊹𒌑	LTB
𒉆𒄩𒅈𒋾𒅎𒄥𒀭𒂗𒍪	OLB
𒈗𒁁𒉌𒇺𒁍𒊏𒌷𒈨𒋙𒉡	NEA
𒊹𒈪𒌅𒉡	NEA
𒀸𒉺𒉌𒅟𒇷𒇷𒅟𒀀𒌑𒆷𒀀	NEA
𒂟𒈨𒌍𒀀𒈾𒁲𒈬𒍣	NEB
𒁍𒌑𒌓𒀀𒄩𒀀𒈩𒀀𒈾𒈬𒌨𒊒𒄣𒃻𒄑𒊒𒁀	LTB
𒀊𒉺𒀀𒀀𒈾𒈪𒌅𒌅𒀀𒆗𒁉𒅔	NEB
𒈬𒊌𒈗𒇻𒆠𒈾𒀭𒉌𒉌	NEA
𒀀𒂅𒌒𒍜𒄷𒌓𒊮𒁉	NEB
𒁹𒈬𒋾𒀭𒁕𒃶𒉺𒊩𒍑𒁇𒈨𒌍	OLB
𒀸𒊮𒌓𒈨𒌍𒃻𒊹𒀭𒀝𒌑𒊺𒍦	NEB
𒀭𒁲𒋻𒂗𒀭𒈨𒌍𒂊𒄫𒁉𒌓	STB
𒃻𒄊𒊹𒃻𒆳𒀸𒋩𒆠	NEB
𒀀𒃮𒀀𒂠	SUX
𒄷𒊒𒍪	OLB
𒈗𒀜𒅟𒀀𒈨𒌍𒃻𒀀𒇉𒁀𒉌𒋾	NEB
𒄿𒋼𒀀𒊏𒁍𒍑	NEB
𒇽𒌷𒌅𒋗𒌌𒋾𒆠𒅋𒇷𒆪	MPB
𒈪𒉌𒀭𒌓	OLB
𒉚𒌀𒈨𒌍	LTB
𒁕𒂍𒌉𒃻𒊹𒌑𒊕𒆠𒆠𒋫	LTB
𒀭𒊩𒌆𒄞	SUX
𒀀𒁲𒉈𒇻𒅟	STB
𒃻𒀸𒆠𒁴𒆍𒃲𒀭𒌓𒃻𒆠𒆗𒀕𒆠𒌋𒇽𒌓𒁴𒃻𒊏𒌋𒌋𒉌𒋙𒉡𒀸𒌗𒀳	LTB
𒀭𒅅𒋗𒁕𒀭𒅅𒋗𒁕	STB
𒀸𒅆𒅀𒀸𒌷𒆕𒄩	NEA
𒅖𒌅𒊹𒆜	OLB
𒌓𒅗𒁇𒆪𒁀	OLB
𒁀𒊑𒂵𒁀𒊑𒂵𒑏𒑏𒑏𒍥𒍑𒀀𒈾𒆠𒁉𒃻	OLB
𒌋𒀭𒁮𒆠𒈾	MPB
𒄰𒈬𒊭𒀝𒆪	MPB
𒆠𒉘𒂷𒉌𒅕	SUX
𒈗𒂗𒇷𒇽𒄥𒁍𒋼	NEA
𒁹𒈾𒄭𒅖𒊭	OLB
𒁕𒇷𒄴	NEB
𒀭𒀝𒌋𒀭𒀫𒌓𒀀𒈾𒈗𒋙	NEB
𒀀𒈾𒄩𒆷𒃻𒌉𒃻𒂍𒈬𒈨𒌍𒊹𒌋𒈪𒋻𒌑𒍑𒀭𒌑𒅎𒋛𒁲𒁕	LTB
𒄑𒊒𒁀𒇽𒈬𒌑𒌓	LTB
𒋻𒋗𒈫𒉡𒈬𒋳𒌦𒈨𒌍𒊹𒊩𒋙𒌑𒍑𒆠𒌑𒅎𒍇𒇻𒁕𒂍	LTB
𒍑𒊕𒆠𒀭𒋫	LTB
𒌝𒈠𒁹𒀀𒍣𒊑𒀴𒅟𒈠	MPB
𒀭𒁕𒋗	SUX
𒋢𒌑𒄣𒆷𒀀𒍮𒌑𒈬𒍮𒌑𒃻𒂍𒀀𒃻	LTB
𒌉𒈨𒌍	LTB
𒅇𒌋𒌋𒈠𒀀𒈾𒈗𒌌	NEB
𒀀𒁲𒀀𒉼𒅟𒄿𒄯𒊏𒍮	STB
𒈗𒌓𒈨𒌍𒈠𒁺𒋾𒁷𒌓	STB
𒂄𒈠𒀭𒋗𒊭𒋀𒅀𒇻𒌑𒌒𒆷	MPB
𒉺𒉌𒀠	MPB
𒈗𒋢𒂔𒆠𒃮𒊑𒉡𒌇	STB
𒌈𒁕𒀊𒉽𒊑𒀀	SUX
𒅆𒈨𒌍𒉌𒌓𒌓𒀸𒆳	MPB
𒃻𒆷𒉺𒀭𒄈𒀭𒁇𒌑𒊺𒍣𒁍	NEB
𒅖𒌅𒈬𒋾𒀀𒁀𒀠𒆠	OLB
𒄑𒆪𒀭𒀴𒊏𒆗𒉡𒀸𒆳𒅅𒅆	STB
𒊹𒈪𒄭𒄿	STB
𒅎𒋫𒄥𒊑𒌍	SUX
𒊹𒊩𒊕𒀸	OLB
𒃻𒁀𒈗𒀀𒈾𒀭𒅟𒉌𒋩𒊏	OLB
𒀀𒈾𒂵𒁉	OLB
𒋫𒂉𒈠𒌑𒁄𒈛𒈠	NEB
𒁹𒅆𒁕𒀪𒁀𒋗𒌑𒃮𒁉𒊩𒋙𒈠𒆷𒄩𒆷𒋙𒀸𒂍𒅇𒆠𒊒𒁀𒀪𒈨𒌍𒈬𒈨𒌍𒃻𒆠	LTB
𒁴𒆳𒆳𒆠𒁀𒁉𒇻𒊑𒆧𒈠𒋫𒀀𒋾	NEB
𒌉𒆍𒀭𒊏	OLB
𒊭𒆳𒄩𒋢𒀀𒋾𒌨𒆠𒌑𒋾	NEA
𒅎𒈬𒋙	NEB
𒌑𒋛𒁉𒆷𒋗	NEA
𒄊𒊹𒃻𒈗𒆳𒀸𒋩𒆠𒀜𒆪𒉡𒄑𒁀𒌅	NEB
𒉣𒇬𒄩𒆷𒃻𒀀𒃻𒌋𒈬𒍮𒌑𒃻𒁉𒈩𒋙𒉡𒊹𒌑𒊕𒆠𒀭𒋫	LTB
𒊹𒌉𒊏𒊹𒌉𒊩𒃮	OLB
𒋾𒋗𒌑𒃻𒀸𒊹𒌓𒈬𒀸𒌓𒈬𒈨𒌍𒈬𒈨𒌍𒅇𒊩𒋙𒃻𒌓𒈬𒀸𒌓𒊹	LTB
𒊹𒀀𒈦𒌈𒂍𒅎𒍇𒇻𒈬𒈨𒌍𒊹𒈦𒌑𒊕𒆠𒀭𒋫𒅎𒈥𒌅𒁕𒋻𒋝𒈬𒋳𒌦𒈨𒌍	LTB
𒆠𒄿𒅋𒇷𒅟𒀸𒌋𒅗𒄭	NEB
𒅗𒌤𒀀𒀭𒈾	SUX
𒀸𒅆𒂍𒃲𒀸𒅆𒉌𒊑𒁉	NEA
𒌷𒍮𒈬𒊑𒆠𒅇𒅋𒋼𒄀	MPB
𒈗𒌓𒀕𒆠𒈠	SUX
𒄷𒇻𒌒𒉺𒀝𒆪𒌓𒅗𒁇	MPB
𒀭𒈪𒅖𒃻𒆥𒈠𒀸𒌷𒁄𒂊𒆷𒅔𒈾𒂇	STB
𒀭𒀜𒄄𒄄	SUX
𒊭𒌋𒁇𒀭𒍝𒂷𒂷	OLB
𒈗𒀭𒌒𒁕𒇹𒁀	SUX
𒀭𒄑𒉢𒈬𒄀𒈾𒆠𒄿𒌑𒍝𒀀𒊹𒊑𒌋𒌋𒉌𒀭𒇽𒈬𒊬𒆠𒋢	NEB
𒅇𒋀𒈨𒌍𒅀𒆏𒁍𒇽𒈨𒌍𒀴	MPB
𒄿𒋫𒀜𒁺𒌑	MPB
𒊹𒆬𒌓𒀀𒀭𒊹𒂆𒉚𒈪𒋻𒀸𒆠𒊒𒁀𒀀𒈬𒈨𒌍𒌀𒈨𒌍	LTB
𒅋𒇷𒆪	OLB
𒀀𒃻𒀀𒌉𒃻𒀀	LTB
𒀀𒄩𒀀𒈩𒀀𒈾𒈬𒊒𒄣𒃻𒉻𒄭𒀀𒈬𒈨𒌍𒊹	LTB
𒁹𒀀𒁲𒌈	OLB
𒀸𒈲𒊑𒆠𒋫𒆷𒋼𒊐𒋙	STB
𒅇𒄿𒆪𒌦𒅟	OLB
𒃻𒌒𒊏	OLB
𒈠𒀀𒂍𒆪𒉡	NEA
𒀴𒅟𒅁𒊑𒊭	MPB
𒀀𒉡𒈠𒌷𒍮𒈬𒌨𒉡𒉽𒌈𒈨𒌍𒈠𒃲	MPB
𒉆𒄩𒅈𒋾𒀭𒀫𒌓𒈬𒊭𒅆	OLB
𒌨𒈬𒌋𒊓𒇷𒈬𒀸𒆳𒅅	STB
𒋢𒆳𒊒𒆠𒂵𒆤	SUX
𒊩𒈠𒃻	NEB
𒁹𒉌𒉌𒌀𒆷𒋾	OLB
𒌋𒈬𒍮𒌑𒃻𒂍𒈬𒈨𒌍𒌋𒁕𒀀𒈨𒌍𒃻𒀀𒃻	LTB
𒅇𒈪𒈾𒄿𒁍𒋗𒈾𒀀𒈾𒆪𒄿𒈾	MPB
𒁹𒅆𒈬𒌝𒀭	OLB
𒅆𒊹𒄊𒊹𒌋𒌋	NEA
𒀀𒈾𒄞𒄭𒀀𒋗𒆪𒅆𒍣𒂵	OLB
𒀲𒊷𒂵	SUX
𒇽𒆥𒄄𒀀𒀊𒉣𒈾𒆠	OLB
𒀭𒈪𒃻𒀸𒍣𒁀𒉌𒋾𒅖𒆪𒉡	NEB
𒀀𒈾𒊹𒄿𒉆𒁷𒂍𒋗𒈫𒈬𒈨𒌍𒀀𒁲𒊹𒈬𒀭𒈾𒈨𒌍𒄿𒊩𒅆𒈠	LTB
𒋀𒅀𒅇𒉿𒀉𒈪𒀀𒈾𒌷𒆠	MPB
𒊹𒋗𒆸𒆸𒊹𒌑𒍑𒊹𒌑𒊕𒆠𒈪𒋚𒌈𒂍𒈬𒈨𒌍𒂍𒈬𒈨𒌍	LTB
𒂊𒊒𒌒𒀭𒉌𒊮𒁉𒄿𒁲𒉼𒉌𒉌	NEA
𒊭𒀝𒈾𒆪𒁾𒉺𒀭𒈾𒅔𒊬	MPB
𒃻𒌓𒈬𒀸𒌓𒈬𒈨𒌍𒈬𒈨𒌍𒄑𒊒𒁀𒇽𒄈𒇲𒌑𒌓𒈬𒈨𒌍	LTB
𒀸𒌋𒅗𒊭𒀸𒋼𒀀	NEA
𒀀𒀀𒈾𒌓𒈬	LTB
𒅟𒀀𒁺𒌋𒂗𒉣	NEB
𒀸𒌗𒍩𒆕𒌍𒂍	STB
𒀀𒈾𒆳𒈨𒌍𒋗	MPB
𒅇𒌉𒈨𒌍𒅀𒇽𒈨𒌍𒀴𒊭𒈗𒂗𒅀	MPB
𒇽𒂟𒈨𒌍𒆷𒄠𒉡	NEA
𒃻𒋡𒋾𒉌𒇻𒃲𒇷𒁀𒈾𒅆	NEB
𒅇𒁳𒄣𒋙𒉡𒈾𒊓𒄷	NEB
𒉺𒋡𒊑𒀀𒈾𒌋𒅗𒄭𒂍𒅇𒌑𒉡𒌑𒌓𒂍𒈬𒈨𒌍𒀉𒋰𒋗𒌑	LTB
𒀴𒈨𒌍𒅟𒊹	NEA
𒉣𒇬𒌋𒈬𒌁𒌈𒊹𒍑𒆠𒌑𒅎𒍇𒇻𒁕	LTB
𒅗𒈝𒈠𒋫𒅗𒈝𒈠	LTB
𒈠𒀀𒋫𒊮𒁉𒂍𒃲𒄑𒊓𒌓𒌋𒉌	NEA
𒆠𒋙𒍣𒉌𒊹𒊹𒀀𒋛𒀀𒈗𒌵𒆠𒌀	STB
𒊩𒆳𒋫	NEA
𒁹𒊏𒈠𒌈𒌉𒃮𒌉𒉌	OLB
𒀀𒃻𒁮𒌉𒃻	LTB
𒀭𒈪𒊹𒃻𒀭𒉿𒂡𒁹𒊮𒋫𒃮𒁉𒉌𒄿𒊑𒃻𒀀𒀊𒁀	STB
𒀭𒁈𒌋𒌓𒆤𒃻𒊏	SUX
𒂍𒀭𒂗𒆤	SUX
𒀸𒌷𒊺𒊹𒀭𒀝𒅆𒌋𒌋𒉌	NEA
𒊹𒌉𒋳𒈠𒆷𒀭𒀫𒌓𒈠𒀭	OLB
𒀀𒈾𒊹𒀀𒈾𒌓𒈬𒍝𒀀𒌓𒀸𒀭𒁷𒁍𒌑𒌓𒀀𒄩𒀀𒈩	LTB
𒊹𒌉𒊩𒃻𒁮𒀀𒃻𒇽𒋛𒌓𒃻𒂵𒊹	LTB
𒁹𒅖𒆠𒅆𒀀𒅀𒅟𒄠	MPB
𒈠𒅇𒇷𒋼	MPB
𒁁𒈠𒊩𒋳𒋳𒋳𒀜𒅘𒈠𒊒𒀀	STB
𒀀𒈾𒄊𒈨𒌍𒁹𒈗𒂗𒅀	MPB
𒋀𒋙𒌉𒃻𒀀	LTB
𒈨𒅖𒊺𒁇𒄑𒍢𒀉	NEB
𒇽𒄩𒍝𒀭𒊭𒁹𒈗𒊑	MPB
𒌑𒌌𒂊𒁲𒄿𒉡𒈠	MPB
𒊭𒂵𒆠𒉺𒈥𒌅𒇽𒉌𒋛𒅔𒆠	OLB
𒋻𒁀𒊍𒌋𒊹𒋀𒋙𒊹𒌋𒈪𒋻𒌑𒊕𒆠𒀭𒋫𒅎𒈥𒌅𒁕𒂍	LTB
𒁹𒄀𒈪𒈝	OLB
𒊭𒈠𒉡𒌝𒆠𒈠𒉌𒅆𒅀𒍪𒀊	OLB
𒀭𒇷𒁉𒀉𒁹𒁯	SUX
𒀭𒅗𒄭𒂵𒋭𒁉𒁮𒁉𒊩	SUX
𒌉𒃻𒇽𒈾𒁷𒄑𒊒𒁀𒈬𒈨𒌍	LTB
𒊹𒊩𒊕𒀸𒊭	OLB
𒋗𒌓𒉿𒊭𒃶	MPB
𒀭𒀭𒁀𒋾𒆷𒀭𒁲𒋻	SUX
𒈬𒍮𒌑𒃻𒊮𒁉𒅆𒁺𒀀𒈾𒊹𒇽𒈾𒁷𒂍𒈬𒈨𒌍𒊹𒌑𒍑𒆠𒌑𒅎𒍇𒇻	LTB
𒄖𒊌𒋡𒉌𒂊𒌋𒃻𒈬𒈨𒌍𒃻𒌉𒃻	LTB
𒃷𒉺𒋼𒋛𒅟𒆤	SUX
𒀀𒈾𒋃𒀭𒅟𒉌𒋩𒊏	OLB
𒀸𒉌𒆸𒌈𒁹𒌷𒀸𒁁𒆠𒌓𒌁𒋙𒉡𒋾	NEB
𒊹𒁤𒋾𒊬	SUX
𒀭𒌓𒅀𒀭𒌓𒊭𒅖𒌅	MPB
𒅋𒋫𒀮𒊒𒉡𒌋𒀉𒋾𒀴𒈨𒌍𒃻𒈗	NEB
𒅇𒆠𒄿𒀉𒆗𒈾𒀭𒌌𒁺𒍪𒈪𒋻𒀸𒊹𒄑𒊒𒁀	LTB
𒀭𒀀𒉏𒌋𒌋𒀭𒈨𒌍𒈪𒉭𒋫𒉌𒄷	STB
𒇯𒁺𒈠𒋫𒊮𒆪𒌑𒊑𒋫𒀮𒁍𒍑	STB
𒀀𒈾𒁹𒀭𒌓𒈬𒉡𒀀𒈾𒌓𒈬𒍝𒀀𒌓𒈾𒋗𒌑𒂍𒋗𒈫𒅇𒈬𒍮𒌑𒋙𒈬𒈨𒌍	LTB
𒌗𒊺𒆭𒆭𒁕	SUX
𒌌𒌅𒀭𒃽𒄯𒊕𒌦𒈠𒅆	STB
𒀭𒈨𒌍𒃲𒈨𒌍𒀾𒋥𒆳𒍑𒃻𒊒	STB
𒀀𒉿𒀠𒆠	SUX
𒀀𒈾𒅆𒂟𒁴𒄿𒄩𒊓𒋢	STB
𒇽𒃲𒌷𒈨𒌍𒉌	NEA
𒊩𒌉𒀀𒈾𒈪𒉌𒊭𒂊𒈪𒀉	OLB
𒊭𒀭𒀫𒌓𒈾𒍢𒅕𒉺𒀀𒇉𒀀𒋩𒀸	OLB
𒇽𒋛𒁲	SUX
𒀀𒃻𒀀𒃻𒁹𒆠𒆗𒀭𒃽𒀀𒁹𒇻𒍑𒌓𒈥𒀭𒅎	LTB
𒈾𒁕𒆪𒉡𒇻𒋫𒄭𒁉𒀸𒍮𒌝𒈨𒂊𒈬𒌋𒋫	STB
𒋞𒂍𒐐𒉆𒃶𒋻	SUX
𒄥𒁀𒊑𒂵𒑏𒍥𒁕	OLB
𒀭𒈗𒀊𒀀	SUX
𒀀𒈾𒄩𒆷𒃻𒌉𒃻𒂍𒅎𒋛𒁲𒅁𒋙𒀸𒀀𒊬𒈬𒈨𒌍𒊹𒑛𒌑𒍑𒀭𒌑𒅎𒋛𒁲𒁕	LTB
𒇽𒈬𒁺𒀀𒃻𒀀𒀀𒃻	LTB
𒊭𒆗𒍣𒌦𒈨𒌍𒋙	NEA
𒌓𒊑𒇺𒀀𒀠	NEA
𒇻𒊺𒁉𒇷	NEB
𒀭𒌫𒀀𒋭𒋗	SUX
𒂊𒁀𒈾𒆕𒀀	SUX
𒃻𒌗𒊻𒋢𒌦𒈬𒀭𒈾𒄖𒊌𒋡𒉌𒂊𒌓𒀊𒀊𒈨𒌍	LTB
𒅇𒄿𒉺𒈥𒌅	OLB
𒀀𒈾𒅖𒆠	NEB
𒂊𒌅𒀸	NEA
𒁹𒀭𒅎𒊺𒈪	OLB
𒀀𒈾𒄩𒆷𒃻𒌋𒀀𒈨𒌍𒂍𒅎𒋛𒁲𒌈𒋙𒀸𒀀𒊬	LTB
𒈿𒄑𒄩𒇻	SUX
𒀭𒌓𒈠𒄫	OLB
𒀀𒈾𒅟𒋙𒉡𒋀𒈨𒌍𒆪𒉡𒌉𒈨𒌍𒆪𒉡	STB
𒊮𒊭𒀠𒆷𒀜𒀭𒁕𒃶𒈠𒀭	OLB
𒅇𒇻𒄴𒁲𒈗𒂗𒅀	MPB
𒁹𒇻𒊭𒅆𒁁𒉌	OLB
𒄿𒇻𒊭𒄿𒈾𒉺𒉌𒅀𒆷𒀉𒁍𒌑	STB
𒀀𒌉𒃻𒀀𒌋𒁹𒀭𒈹𒋀𒈨𒌍𒈬	LTB
𒍣𒂵𒃻𒋗𒀭𒂗𒍪𒊺𒈪𒉺𒀀𒋛𒊑	OLB
𒌉𒃻𒀀𒌝𒈬𒂍𒋗𒈫𒀜𒌅𒅟	LTB
𒄿𒆠𒍢𒁍𒌋𒌋𒈠𒅟𒆷𒈨𒌌𒄿𒁲𒊩𒋫	NEB
𒁹𒈗𒊑𒁁𒅀𒀭𒅀𒀭𒌓𒅀𒅇	MPB
𒃻𒁀𒈗𒀀𒈾𒀭𒊏𒈠𒉡𒌝	OLB
𒀀𒈾𒆪𒅇𒁹𒀀𒉿𒌋𒅗𒌷𒆠	MPB
𒀭𒂗𒉡𒄄	SUX
𒀭𒂄𒈪𒀀𒁺𒁺𒈫	SUX
𒀀𒉡𒈠𒂊𒋗𒅆𒊒	MPB
𒀠𒋃𒌓𒈨𒌍	NEA
𒀭𒈠𒄀𒊒𒋗	SUX
𒈬𒊹𒁹𒋛𒇻𒆪𒈗	LTB
𒊓𒀭𒁲𒊹𒆦𒀭𒉈𒊹𒆦𒅎𒆬𒄀	STB
𒌈𒍣𒊏𒀀	SUX
𒉌𒌓𒋗𒋰	SUX
𒀭𒀫𒌓𒈬𒊭𒅆𒃻𒋗𒀭𒂗𒍪𒊺𒈪𒉺𒀀𒋛𒀸	OLB
𒀭𒊹𒆳𒂄𒁍𒌓𒋾𒌑𒋀𒈨	STB
𒉆𒈠𒁕𒁺	SUX
𒂟𒈨𒌍𒄿𒄷𒄭𒌅𒅇	NEB
𒊹𒀀𒃻𒀀𒀀𒃻	LTB
𒊭𒄿𒈾𒅟𒀀𒇉𒀸𒀸	OLB
𒉆𒈬𒈾𒋻𒁺	SUX
𒁹𒊑𒅁𒀜𒁲𒅅𒁉	MPB
𒊹𒀭𒀸𒋩𒋀𒋧𒈾	NEB
𒊹𒊹𒄘𒌦𒆬𒌓𒊹	SUX
𒀉𒆗𒋙𒉡𒌓𒁍𒌓𒉺𒈛𒄩𒇽𒊑𒋛𒉡𒆷𒁁𒆷𒃻𒅟𒉡	LTB
𒈾𒀜𒉡𒀀𒄩𒈨𒌍𒆠𒄿	NEB
𒀭𒀝𒌋𒀭𒀫𒌓𒀀𒈾𒁁𒉌𒅀	NEB
𒈲𒁀𒄙	SUX
𒉈𒂊𒈪𒃻𒆳𒀉𒋾𒅟𒀉𒁍𒁍	NEB
𒅇𒀉𒁷𒉡𒀭𒈨𒌍𒊭𒈗𒁁𒉌𒅀	MPB
𒀭𒊮𒍪𒈤𒁾𒉄𒌦𒈠𒆤	SUX
𒀀𒈾𒈗𒂗𒅀𒀀𒉺𒅁𒌓	NEA
𒈹𒉡𒁺𒈬	SUX
𒀀𒈾𒀀𒃶𒈾𒅟	NEB
𒊹𒀸𒋩	NEB
𒀭𒌓𒃞	SUX
𒂙𒌉𒌒	STB
𒁹𒄩𒈪𒅖𒋾𒀭	OLB
𒊹𒊹𒌓𒊹𒄰𒅆𒇲	STB
𒋫𒌷𒂟𒉼	NEA
𒄿𒊬𒊏𒁍𒅆𒄿𒈾𒉈	MPB
𒋳𒈠𒋻	STB
𒌉𒋙𒄿𒋛𒌋𒌋	NEA
𒊹𒋀𒋙𒉡𒌉𒃻𒊹𒈠𒆟𒀪𒂊𒋩𒀪	LTB
𒌑𒋗𒊑𒀀𒄠	OLB
𒄀𒉆𒈠𒅟𒀀𒀀𒉌𒅖𒈲𒀸𒂍𒇽𒅆𒃻𒄊𒈨𒌍𒋙𒌑𒊺𒄑𒍝𒀀	STB
𒈠𒀀𒁍𒌑𒂊𒈾𒆠𒋛	NEA
𒊹𒀭𒀝𒌑𒊩𒅆𒁁𒉌𒆪𒉡	NEB
𒅇𒆏𒁉𒇽𒈨𒌍𒄿𒊏𒄩𒈬𒋗	MPB
𒆠𒊹𒀭𒂗	NEB
𒂍𒀭𒅎𒃻𒆠𒆗𒀕𒆠𒍑𒀭𒌑𒅎𒋛𒁲𒁕𒂍𒀀	LTB
𒌉𒃻𒀀𒊕𒆠𒀭𒋫	LTB
𒅁𒇻𒋫𒊹𒁕𒀭𒈾𒈪𒈾𒄿𒁍𒋗𒈾𒉿𒉿𒅆𒊏𒈗𒊒	MPB
𒇻𒌑𒁲𒈬𒀀𒈾𒈗𒁁𒉌𒐊	NEA
𒌋𒌋𒌋𒌋𒌋𒌋𒁲𒅂𒃷𒃷𒃷	SUX
𒌋𒈠𒀀𒁺𒈠𒆷𒁀𒋗𒌑𒃮𒁉	LTB
𒀀𒇉𒈬𒃻𒀾𒉌𒌓𒉌𒅁𒋾	NEA
𒋀𒋙𒌉𒃻𒀀𒀀𒈾𒌓𒈬𒍝𒀀𒌈𒄿𒉆𒁷	LTB
𒁳𒁉𒈠𒆷𒅖𒀪𒀠𒋙	NEB
𒀀𒈾𒌓𒈬𒍝𒀀𒌓𒋗𒌑𒇽𒈬𒁺	LTB
𒆷𒀠𒇷𒅟	NEA
𒆠𒄿𒈩𒁲	NEB
𒀭𒂖𒆷𒈪𒂊	STB
𒉌𒁍𒍑	NEA
𒀀𒃻𒌑𒈥𒊩𒋡𒈠𒀀𒁲𒊹	LTB
𒇷𒁍𒍑𒀸𒁷𒌁𒆠	NEB
𒀀𒀊𒊬	SUX
𒃻𒀀𒄣𒆷	STB
𒁀𒉌𒋾𒅀𒆠𒂊𒁍𒊹𒀭𒀝𒀉𒅅	NEB
𒀭𒁁𒂖𒄿𒆷𒁴	SUX
𒁹𒅖𒆠𒇷𒌋𒅗𒅀	MPB
𒊭𒅖𒌅𒄿	OLB
𒀭𒄃𒀭𒀫𒌓	SUX
𒊮𒆳𒄿𒁕𒀊	STB
𒁲𒂊𒈨𒁮𒄣	NEB
𒇻𒌓𒅟𒄩𒊏𒈨𒈠	NEA
𒈗𒆳𒆳𒂗𒉌	NEB
𒉺𒁽𒂠𒈠𒀭𒋧	SUX
𒌌𒀠𒋃𒀀𒁲𒄿	NEB
𒀭𒊊𒈤𒈫	SUX
𒀀𒆠𒇻𒌷𒈨𒌍𒆪𒉡𒆳𒆪𒉡𒀀𒊮𒈨𒌍𒆪𒉡𒇻𒃻𒆠𒇻	STB
𒀀𒈾𒄩𒁀𒅆𒅖𒌅	MPB
𒊩𒋀𒊕𒍑𒈬𒆸𒆰𒆳𒁹𒀭𒀀𒉏	STB
𒈗𒁁𒉌𒀀𒋼𒀀𒊐𒉈𒂊𒈬	NEB
𒋗𒌑𒀭𒈨𒌍𒃲𒈨𒌍𒇷𒀪𒌑𒋾	NEB
𒀀𒇉𒈦𒄠𒋢𒇻𒉡𒈾𒃮𒉡𒄴𒋙𒀀𒇉𒈦𒄠𒋢𒇻𒉡𒈾𒃮𒉡𒄴𒋙	STB
𒀀𒈾𒀀𒁉𒅟𒅇𒉿𒌍𒈨	MPB
𒃻𒋗𒉌𒉌𒅁𒉺𒀠𒊓𒄠	OLB
𒊭𒅖𒌅𒂟𒊮𒄞	OLB
𒀀𒅆𒁍	MPB
𒀀𒁮𒂄𒆠	SUX
𒉌𒋛𒅔𒆠𒌷𒆠𒉆𒈗𒆷	SUX
𒊑𒁺𒌓𒀀𒁉𒅀𒌈	OLB
𒁹𒁕𒁺𒌝𒊏𒁉	OLB
𒅀𒀀𒁲	MPB
𒀭𒉎𒃲𒂔𒈾𒋗	SUX
𒃻𒈬𒉡𒄀𒄀𒌋𒅎𒇲𒀀𒁀𒃻𒀭𒈹𒄩𒁹𒅆𒁇𒋢	STB
𒅇𒊹𒆷𒀀𒋼𒄑𒍣𒅁𒄿𒈾𒊮𒁉𒋗𒉡	MPB
𒌦𒋡𒐕	LTB
𒃻𒆠𒈠	SUX
𒌑𒋼𒊏𒋗𒉡𒋾	OLB
𒆷𒋗𒊹𒈗	NEB
𒌗𒇯𒆬𒌓𒄰	OLB
𒁹𒀭𒌓𒄿𒁷𒉆𒇽𒂍𒆯	OLB
𒀸𒌋𒅗𒄭𒅀𒈠𒀪𒁕	NEA
𒊑𒅖𒀭𒌓	OLB
𒊹𒇽𒈾𒁷𒈾𒄑𒊒𒁀𒈬𒈨𒌍𒅇𒋀𒋙	LTB
𒀭𒉇𒁔𒀭𒀫𒌓	SUX
𒅟𒁍𒌓𒄞𒀲𒇻𒈨𒌍𒀲𒆳𒊏𒈨𒌍𒀸𒆳𒋙𒀀𒀀𒅁𒅆	STB
𒊑𒄴𒌓	NEA
𒅖𒁍𒊏𒊹𒋀𒁮𒆠𒀀𒈾𒋙	NEB
𒂍𒈬𒈨𒌍𒄿𒍢	LTB
𒌅𒋳𒆏	STB
𒅇𒁷𒌁𒆠𒈠𒁲𒅖𒆗𒈾𒀜	NEB
𒄭𒇷𒁍𒌑	STB
𒌅𒂊𒉈𒉡𒊏	MPB
𒀭𒂗𒁺𒋗	SUX
𒄿𒄙𒀸𒁺	OLB
𒊹𒊹𒀸𒌗𒁈𒇻𒌓𒊹𒄰𒇻𒌓𒊹𒄰	STB
𒋫𒌋𒅗𒀀𒇉𒈬𒃻𒀾𒉌𒋾	NEA
𒁹𒂠𒍪𒌑𒃻𒁹𒀭𒋾𒀪𒌑𒆪𒋢𒉽𒁀𒉡𒌑𒌓𒀀𒈾𒉚𒌀𒈨𒌍𒀀𒈾	LTB
𒈠𒀀𒀊𒋫	NEA
𒆠𒄿𒀉𒁍𒌑𒂟𒈨𒌍𒀉𒂁	NEB
𒁶𒍜𒇻𒉏𒊩𒉏𒌋𒅗𒋙𒉡𒇷𒁳	STB
𒄑𒄯𒂊𒋛𒄣𒂊𒋛𒄣𒄑𒀫𒌓	STB
𒈬𒈾𒂄	SUX
𒅔𒁉𒅕𒍢𒁴	OLB
𒊹𒊹𒌓𒊹𒄰𒅆𒅕	STB
𒈪𒌅𒌅𒆷𒉺𒀭	NEB
𒅇𒀀𒉌𒋫𒇷𒈪𒉺𒋼𒋛𒈨𒌍	OLB
𒈠𒆷𒁳𒁍𒋙	NEB
𒊭𒀀𒈾𒇽𒊕𒇻	NEA
𒁹𒃻𒄭𒆷𒀀𒅇𒀀𒈨𒌍𒃻𒇽𒆕𒍑𒌋𒌆𒇻𒅎𒄭𒀀𒃻𒂍𒀭𒈨𒌍𒃻𒀕𒆠	LTB
𒌦𒋡𒁹𒊑𒉺𒀭𒈹	LTB
𒊹𒁮𒁉𒊩	SUX
𒀭𒄋𒉣𒈾𒈫	SUX
𒈬𒄰𒋾𒊭𒀜𒋾𒀭𒉌𒋾𒆠𒄿𒊭𒁖𒁍𒌑	MPB
𒊹𒌉𒀀𒉿𒅋𒀭𒅎	OLB
𒀀𒃶𒈾𒆷𒄑𒍝𒊍𒍣𒊹𒆰𒌑𒋾𒐊	NEB
𒈗𒁁𒉌𒅀𒀜𒋫𒀭𒌓	MPB
𒈗𒂍𒈤𒂊𒅔𒉚	SUX
𒇽𒄖𒋾𒌝	OLB
𒀀𒈾𒊩𒌆𒋚𒉺𒋗𒄿𒍣𒂵	OLB
𒅁𒁍𒋙𒉌𒋾𒀉𒍣	NEA
𒆪𒄑𒋛𒋗𒉡	NEA
𒁕𒊑𒋼𒆠𒈠	MPB
𒌅𒋚𒋃	STB
𒊮𒁉𒈗𒄭𒂵𒈧𒀲𒆳𒌵𒆠	STB
𒌑𒊓𒉡𒈠𒀀𒊹𒈬𒊺𒍦𒀭	NEA
𒂞𒊕𒁀𒉌𒈪𒃮	SUX
𒌉𒃻𒀸𒋗𒈫𒌉𒊩𒃻	LTB
𒀀𒃻𒍑𒆠𒌑𒅎𒍇𒇻𒁕𒂍𒋗𒈫𒋫𒂍𒈩𒋾𒃻	LTB
𒀀𒉈𒀝𒆠	SUX
𒅆𒈠𒀜𒅆𒈠𒀜	MPB
𒅇𒈠𒍝𒅈𒋾𒈗𒊑	MPB
𒈠𒀀𒀸𒌋𒅗𒄭𒋙𒄑𒁍𒈠𒀀𒆠𒄿	NEA
𒁁𒄑𒁍𒋛𒈨𒌍𒋙𒀀𒊬𒉿𒊹𒋙𒊹𒌋𒆏𒃻𒈨𒌍	STB
𒁀𒊏𒊒	MPB
𒀀𒈾𒈬𒃻𒌉𒊩𒃻𒆳𒊑	LTB
𒊹𒆏𒊑𒅎𒋛𒁲	LTB
𒊹𒊕𒀴𒀀𒄷𒋗𒉡	OLB
𒅀𒅋𒋫𒋛𒌝𒈠	NEB
𒉿𒊹𒀀𒈾𒈗𒇺𒊒𒅟	NEB
𒂊𒇴𒈨𒋾𒊭𒋗𒈫𒁹𒉿𒀀	STB
𒌌𒀉𒁷𒌑𒅟𒄯𒃻𒀭𒆠𒄿𒅋𒌨𒌑𒊹𒇧𒇻𒂅𒄑𒍝𒅟𒀪	NEB
𒅇𒂗𒈾𒇽𒈠𒀝𒌅𒌅𒃻𒌌𒌅	NEB
𒀭𒊏𒄀𒈬𒀭𒅎	STB
𒊭𒆳𒄩𒉌𒃲𒁁	MPB
𒌒𒌓𒀸𒌋𒅗𒄭𒅀𒇸𒇷𒆪𒉌𒇽𒈤𒈨𒌍	NEA
𒇽𒊹𒌑𒊭𒌷𒄿𒊓𒈾	NEA
𒄖𒄖𒍝𒆳	SUX
𒈾𒊒𒃻𒀉𒋾𒈲𒊕𒆗𒊮𒀭	STB
𒊹𒊕𒀸𒊹𒌉𒃮	OLB
𒉆𒄩𒅈𒋾𒀭𒂗𒍪𒈾𒍢𒅕𒌉𒂍𒁾𒁀	OLB
𒀸𒄷𒌓𒊮𒁉𒋙𒄑𒊒𒁀𒋙𒊹	LTB
𒄀𒌋𒄭𒃻𒉆𒊑𒊑𒀖𒁍𒋗𒈠𒇻𒌑𒇧𒄩𒀀𒋾	STB
𒀀𒈾𒉺𒉌𒋙𒉡𒌌𒊑𒋃	NEB
𒊹𒊹𒆳𒈠𒆏𒋙	STB
𒊹𒊹𒉡𒅆𒈠	STB
𒆬𒀭𒊩𒌆𒃲	SUX
𒌉𒆍𒀭𒊏𒆠	OLB
𒉈𒈬𒅖𒆪𒈾𒀭𒉌	NEA
𒀸𒅆𒅀𒀀𒊑𒈗𒄿𒌑𒈨	NEA
𒊹𒃻𒉌𒌈𒃻𒂍𒈬𒈨𒌍𒌋𒁕𒂍𒌉𒃻𒊹𒌑𒊕𒆠𒀭𒋫𒅎𒈥𒌅𒁕𒆠𒊒𒁀𒀀𒃻	LTB
𒈬𒌨𒊒𒄣𒃻𒄑𒊒𒁀𒇽𒆭𒂍𒌑𒌓𒈬𒈨𒌍	LTB
𒁀𒊑𒂵𒑏𒑏𒊺𒊹	SUX
𒇽𒁺𒌦𒉡𒌝	OLB
𒉈𒂊𒈬𒊭𒊹𒄷𒌝𒁉𒂊	NEA
𒊹𒊹𒀸𒅆𒇲𒋙𒂇𒀀𒌓	STB
𒊹𒊹𒌋𒌋𒍝𒊍𒋢𒄀𒈾𒁺𒄑	STB
𒆷𒄿𒈾𒀾𒅆𒀪𒌋	NEA
𒂗𒉡𒌦𒑛	SUX
𒀀𒈾𒅀𒅆𒅖𒌅𒈬𒆏𒁉𒀀𒉿𒋾𒈗𒊑𒅀𒅖𒋼𒈬	MPB
𒁉𒀭𒀫𒌓𒆠𒄿𒅁𒆷𒄷	NEB
𒆠𒄿𒀉𒁷𒌋𒆠𒄿𒀉𒆗𒉡𒌌𒁺𒍪𒌋𒄿𒉆𒁷𒃻𒆷𒁲𒋻𒌋𒆷𒄩𒊏𒊏	LTB
𒊑𒁺𒌈𒊭𒀭𒀫𒌓𒈾𒍢𒅕𒉺𒀀𒇉𒀀𒋩𒀸	OLB
𒊹𒌉𒃮𒌉	OLB
𒊩𒄩𒁉𒋾𒀀𒈨𒀀𒀀𒄴𒁀𒀀𒀀𒈨𒌍𒅘𒁉	STB
𒊹𒀾𒆠𒊒𒍑𒄷	MPB
𒌅𒋼𒊒𒈾𒇽𒈨𒌍	MPB
𒄴𒍪𒊻𒌝𒈠𒀀𒆷𒀀𒊩𒈬𒆏𒁍𒊭𒁖𒁍𒌑	MPB
𒃲𒈨𒌍𒅅𒈨𒌍	STB
𒊮𒂍𒅆𒁾	OLB
𒈬𒈾𒉌𒃻	SUX
𒍑𒅆𒅕𒋾	MPB
𒊹𒇽𒈾𒁷𒂍𒆠𒊒𒁀𒀪𒈨𒌍𒌋𒄑𒊒𒁀	LTB
𒄑𒍝𒊍𒀀𒁲𒉺𒋫𒊑𒋗	MPB
𒀵𒊏𒉌	SUX
𒀭𒂄𒊮𒂵𒈾𒅟𒆤	SUX
𒊕𒂠𒈬𒉌𒉺𒄸	SUX
𒁲𒂊𒈠𒊕𒉡𒌝𒈠	NEB
𒊹𒊕𒀴𒊭𒊹	OLB
𒄈𒀭𒁇𒋙𒌨𒋗𒌓𒋢	STB
𒀸𒆳𒄿𒋫𒈥𒆪𒌋	NEA
𒅇𒀜𒋫𒌅𒁀𒇷𒌅	MPB
𒁹𒀭𒌓𒄿𒁷𒉆𒇽𒀊𒉣𒈾𒆠	OLB
𒀸𒌓𒈬𒋗𒀀𒌅	STB
𒀸𒌋𒅗𒄭𒂍𒋗𒈫𒈬𒈨𒌍𒃻𒀸𒂍𒈬𒌁𒌈𒃻𒆍𒃲𒌑	LTB
𒊹𒊕𒀴𒊭𒀭𒀫𒌓𒈾𒍢𒅕𒊭𒁉𒅕𒀀𒋩𒀸	OLB
𒆠𒄿𒃻𒀀𒀀𒇻𒁉𒋗𒁺𒌋𒉌𒁲𒆪𒌋𒉌𒀀𒈾𒅟𒀀𒋙𒉡	STB
𒈠𒄠𒈠𒌓𒈥𒈠𒋳𒈠𒉌𒌓𒌒𒁍𒊌𒁹𒁕𒀊𒋾𒂊𒅆𒋾	STB
𒀀𒈾𒂍𒀀𒋛𒊑	OLB
𒁹𒈾𒊏𒄠𒉌𒉌𒋗	OLB
𒉺𒈥𒌅	OLB
𒊹𒌓𒀉𒅎𒋛𒁲𒌑𒉺𒀀𒄿𒋫𒆸𒋢𒅥𒈗𒉏𒈠𒆠	STB
𒊹𒇽𒀀𒋛𒀸𒋢𒌅𒈨𒌍	OLB
𒌋𒀸𒀸𒀸𒀸𒀸𒀸𒀸𒀸𒀸𒄥𒊺𒊹	SUX
𒆠𒈫𒆠𒈫𒆠𒄿𒃻𒀀𒈨𒌍𒀸𒊮𒋳𒆪𒋛𒋫𒀮𒉺𒄩𒀀𒉌	STB
𒁍𒌓𒋳𒌌𒌅	NEB
𒀀𒃻𒀀𒀀𒃻𒌉𒃻	LTB
𒌨𒊕𒀭𒂗𒂍𒇲	SUX
𒊹𒃻𒁺𒇽𒈦𒈦	NEB
𒁹𒀭𒈹𒈬𒆚𒇽𒋃𒌉𒃻𒊹𒀕𒆠𒌗𒋗𒌓𒊹	LTB
𒈗𒆷𒄿𒁄𒇻𒄷	NEA
𒅕𒌅𒌑𒁍𒌋𒉌𒈠𒀀	NEA
𒃷𒁀𒆳𒁉𒌉𒀭𒅎𒊏	STB
𒂊𒋼𒋾𒅅	NEA
𒌌𒌅𒊑𒌍𒅎𒈠𒌨𒆪	NEB
𒇽𒈬𒆥𒉡𒀀𒋙	LTB
𒊒𒊻𒍮𒉡𒈬𒊻𒋢𒌑	STB
𒄩𒀀𒀀𒁕𒋼𒉿𒋼𒈠	STB
𒆠𒄿𒀭𒉌𒄿𒋡𒁉𒈠𒀀𒀸𒌷𒆜	NEA
𒌌𒅅𒁀𒀀𒅇𒂗𒈾𒊹𒆰𒌑𒌅	NEB
𒅔𒈾𒇲	SUX
𒌗𒀭𒊩𒌆𒂍𒃲	STB
𒌋𒌋𒈠𒀸𒉿𒅀𒅋𒋼𒈨	NEB
𒈗𒆳𒉏𒈠𒆠	NEA
𒀀𒈾𒌉𒌋𒌋𒂗𒋙𒆠𒄿𒋢𒊏𒊑𒌑𒈠𒍢	STB
𒊹𒐞𒐞𒐞𒄥𒊺𒊹	SUX
𒊹𒀜𒆤𒈨𒌍	OLB
𒊹𒀸𒌗𒁈𒌓𒊹𒆚𒀭𒈪𒃻𒈗𒆳𒁉𒈪𒉭𒈠𒋾𒌓	STB
𒇽𒀀𒆥𒃻𒈗𒁷𒌁𒆠	NEB
𒊑𒅅𒋢𒃻𒀸𒃻𒀭𒈾𒀀𒆳𒊑𒌑𒃻𒀭𒉡𒌑	LTB
𒌅𒌑𒂵𒌒	STB
𒈬𒉌𒇻𒌋𒊓	STB
𒌋𒈪𒋻𒂍𒋢𒃻𒌋𒅗𒉡𒂍𒋗𒈫𒈬𒈨𒌍𒄿𒍢𒌋𒈠𒀀𒁺𒈠𒆷𒁀𒋗𒌑	LTB
𒃮𒋙𒁺𒄰	STB
𒂍𒃲𒁹𒀭𒊹𒆕𒌉𒍑𒈗𒋙𒈗𒆳𒀸𒋩𒆠	STB
𒀀𒈾𒌓𒈬𒍝𒀀𒌓𒀀𒈾𒀀𒄩𒈩𒈾𒋗𒌑𒈨𒌍𒊹𒅎𒃻𒁕𒊑𒋾𒌑𒇽𒈬𒁺	LTB
𒆠𒊒𒁀𒀀𒃻𒂍	LTB
𒉌𒌓𒌍𒄥𒌈𒍝𒆳	SUX
𒈾𒁉𒉌𒉌𒋗	OLB
𒊹𒌉𒃻𒊹𒌉𒃻𒊹𒀀𒁹𒂠𒍪𒌑	LTB
𒉺𒉌𒂗𒈗𒈨𒌍	NEB
𒊩𒈬𒉡	LTB
𒀀𒈾𒁁𒇷𒅀	MPB
𒀭𒈛𒈠𒀭𒀀𒉡𒌝𒌋𒀭𒌈	SUX
𒀉𒋰𒋗𒌑𒀀𒃻𒀀𒃻	LTB
𒇽𒂟𒈨𒌍𒂊𒊭𒈗𒂗𒅀	NEA
𒀭𒀸𒂄𒈨𒀉𒌅𒍢𒀀	NEA
𒅇𒌓𒈬𒊻𒋢	NEB
𒅋𒌨𒌋𒉌𒋫	NEA
𒇻𒇷𒈬𒌦𒇷𒁓𒊏𒊹𒌉𒊏𒀭𒂗𒍪𒄩𒈪𒀉𒌉𒁲𒌈	OLB
𒀀𒉌𒉡𒈗𒁁𒇷𒀭𒂗𒀀𒈾𒆬𒄀𒉌𒌓𒈨𒌍𒃻𒅟𒀀𒀀𒈠𒉡𒊹𒇽	NEA
𒉈𒅔𒌇𒀀	SUX
𒊹𒀸𒀭𒈪𒀯𒊕𒈨𒃻𒁺𒄑𒁹𒈗𒁲𒈬	STB
𒅋𒋳𒉡	NEB
𒊭𒉌𒉌𒅁𒉺𒀠𒍝𒄠	OLB
𒃻𒋻𒁀𒊍𒃻𒂍𒈬𒈨𒌍𒊹𒌑𒍑𒀭𒌑𒅎𒋛𒁲𒁕𒋻𒁀𒊍𒃻𒊹𒊹𒌑𒍑𒆠𒌑	LTB
𒀴𒀭𒈾𒁉𒌝	MPB
𒈬𒈨𒌍𒁀𒋾𒊹𒌉𒃻	LTB
𒀴𒈨𒌍𒊭𒈗𒌅𒄬𒆷𒋡	NEA
𒁁𒉌𒐊𒄿𒉺𒅁𒉺𒊒𒉡	NEB
𒀭𒀫𒌓𒈾𒍢𒅕𒅇𒋀𒀀𒉌	OLB
𒂍𒈨𒌍𒀭𒈨𒌍𒃲𒈨𒌍𒁹𒆠𒅆𒈾𒌑𒋻	STB
𒇻𒌑𒁉𒇻	NEA
𒀀𒁺𒌑	NEB
𒊭𒄭𒊑𒍢𒊭𒀸𒌋𒅗𒄿𒋛𒋼𒉌	NEA
𒂼𒊮𒊨𒀭𒂗𒆠𒅟𒆤	SUX
𒌨𒁉𒈠𒃻𒄿𒄷𒆠𒆗𒉌	NEB
𒅇𒄿𒈠𒃻𒈾𒁕𒀭𒇽𒊓𒄤𒈨𒌍	MPB
𒉈𒄿𒃻𒌓𒊒𒈠𒋡𒌓𒀸𒊮𒁉𒃻	STB
𒆏𒁉𒌷𒆠𒄭𒀀𒅀𒊭𒄿𒋡𒁉𒀀𒈾𒉺𒉌𒂗𒅀	MPB
𒀭𒄖𒆷𒈾𒍢𒅕	OLB
𒀸𒉿𒄿𒃻𒇽𒃲𒈨𒌍	NEB
𒇽𒆠𒋩𒊏𒆠	OLB
𒌉𒃻𒀀𒀀𒈾𒌓𒈬𒍝𒀀𒌓𒀉𒋫𒁷	LTB
𒌋𒂍𒀭𒈨𒌍	NEB
𒉈𒈠𒀀𒁹𒂍𒃲𒆷𒄿𒁉𒆳𒈠	NEB
𒌑𒌌𒈾𒀜𒉡𒉌𒄿𒊑𒁀	MPB
𒆳𒀸𒋩𒆠𒆳𒅴𒆠𒅇𒌵𒆠	STB
𒊹𒊹𒉣𒇬𒆸𒈠𒀯𒇻𒅂𒀸𒊮𒋙𒁺	STB
𒈬𒈨𒌍𒃻𒌉𒃻𒀀𒀀𒈾𒍝𒀀𒌈𒋙𒉡	LTB
𒉿𒍪𒌝𒉡	OLB
𒊹𒀭𒌓𒀳𒌍𒌌𒋼𒁉𒋃𒆪	NEB
𒊹𒊕𒀴𒌉𒊏	OLB
𒅆𒊹𒀭𒈦	NEA
𒆬𒄀𒁮𒃼𒃻𒀀𒈾𒀭𒊩𒌆𒆤	STB
𒈬𒌝𒈬𒁁𒂖𒌈	STB
𒂊𒋰𒋙𒀀𒈾𒈗𒂗𒐊𒅅𒋻𒁍	NEA
𒀀𒈾𒁮𒅀𒊭𒁇𒈗𒀸	MPB
𒇽𒈨𒌍𒉺𒁼𒈨𒌍𒅇	MPB
𒈧𒀲𒈨𒌍𒆳𒌵𒆠	STB
𒌆𒉿𒀭𒊩𒌆𒉾𒄄𒉌𒈾	SUX
𒈠𒀀𒀊𒁍	NEA
𒇷𒁍𒋗𒈨𒈨𒉌𒀸𒊮𒁉𒇻𒆷𒄿𒌓𒊒𒀪	STB
𒀭𒊩𒌆𒄈𒍪𒇽𒈬𒈛	SUX
𒅇𒀭𒈾𒌑𒌌𒀀𒍝𒆠𒈾𒈾	MPB
𒈨𒈛𒄩	SUX
𒃻𒀭𒀸𒁲𒉌𒋙𒅗𒅗	NEA
𒅕𒊑𒄣𒀸𒉈𒋫𒈩𒁲𒌌𒌓	STB
𒄿𒈾𒌷𒍮𒈬𒊑𒆠𒅇𒅀𒉡𒇽𒈨𒌍	MPB
𒌝𒈠𒈪𒅎𒈠𒈠𒆷	NEB
𒌋𒌋𒀀𒈨𒌍𒃻𒌑𒍑𒆠𒌑𒅎𒍇𒇻𒁕	LTB
𒉆𒄩𒅈𒋾𒀀𒈾𒀭𒀫𒌓𒀜𒆗𒋃𒀭𒅟𒉌𒋩𒊏	OLB
𒊭𒌷𒂦𒁾𒉄𒆠	OLB
𒋡𒁺𒂟𒈨𒌍𒅀	MPB
𒈬𒁉𒊩𒈨𒌍𒍑𒈨𒌍𒌌𒆷𒁕	STB
𒀀𒈾𒈪𒉌𒀹𒁯𒆠𒋩𒊏𒆠	OLB
𒈗𒊒𒌑𒀫𒈨𒇻𒈾𒍝𒊏𒋫	MPB
𒆷𒄿𒁄𒆷𒇻	NEB
𒀸𒁀𒀜𒋾	NEA
𒊭𒀀𒋗𒅇𒉌𒅖𒈬𒈪𒅇𒀀𒈬𒌨𒀀𒈾𒆪𒀴𒆠𒋾	MPB
𒌉𒈨𒌍𒆪𒉡𒌉𒊩𒈨𒌍𒆪𒉡𒆷𒋫𒉡𒄩	STB
𒌨𒊩𒌆𒌈𒅆𒂟𒌋𒈝𒉡𒃻𒀸𒀭𒈪𒅅𒁍𒌑𒆠𒌗𒋙𒁹𒆠𒃻𒁹𒆳𒈪𒆟𒋾𒄭𒁉	STB
𒂊𒋫𒀜𒋡𒈠𒀀𒌋𒌆𒇻	NEA
𒈪𒄿𒉡𒊭	NEA
𒅇𒅅𒁍𒉏𒋗𒉡𒀀𒈾𒅀𒅆	MPB
𒉆𒋾𒆷𒉌	SUX
𒀭𒋀𒆠𒅈	SUX
𒂅𒌒𒊮𒁉𒂅𒌒𒍜𒈨𒌍𒀀𒈾𒈗𒂗𒉌𒇺𒊒𒆪	NEA
𒀸𒄷𒌓𒊮𒁉𒋙𒆠𒊒𒁀𒀀𒋙𒆠𒁴𒂍𒊬	LTB
𒀀𒈾𒆪𒈪𒋙𒉡	NEB
𒇽𒄖𒁺𒁕𒉡	NEB
𒂦𒄭𒀊𒋢𒁓𒋙𒂦𒁈𒉺𒇻𒆠	STB
𒀀𒈾𒄊𒈨𒌍𒂗𒉌𒅀𒀭𒈨𒌍𒅀𒀭𒌓𒅀	MPB
𒌓𒊹𒆚𒃻𒌗𒇯𒆬𒌓𒊕𒁺𒋧	NEA
𒇻𒌋𒁲𒈬𒀀𒈾𒌉𒈗𒂗𒅀	NEA
𒀭𒅎𒄑𒆪𒀭𒂗𒆤𒇷𒈠𒀭𒋧	SUX
𒀭𒋚𒀭𒈫	SUX
𒌉𒃻𒌋𒌉𒈨𒌍𒃻𒌉𒃻𒀀𒈨𒌍𒊹𒌑	LTB
𒇽𒄈𒇲𒌑𒌓𒅆𒊹𒀭𒌈𒀭𒈹𒀭𒈾𒈾𒀀𒀭𒃽𒃻𒊕𒌋𒀭𒈨𒌍𒂍𒋙𒉡𒃮𒁉𒃻𒌗𒊻𒋢	LTB
𒀩𒈾𒉌𒈬𒌅	SUX
𒀀𒈾𒉺𒉌𒈗𒁁𒅀𒅇𒇻𒉿𒅆𒊒	MPB
𒇽𒈨𒌍𒄩𒍝𒀭𒉡𒌑𒌈	MPB
𒁈𒀭𒊩𒌆𒄈𒋢𒅟	SUX
𒁹𒀀𒉿𒇷𒅀𒉺𒈥𒌅	OLB
𒀭𒌒𒌦𒈠𒋗	SUX
𒀀𒈾𒊹𒊹𒁺𒉽	NEA
𒊹𒃻𒁺𒌉𒋙𒃻𒊹𒄿𒁀𒀀	NEB
𒈠𒈪𒄿𒉡𒌑𒆷𒈠𒌓𒂊𒍪	STB
𒀸𒊮𒁉𒂊𒁍𒊒𒆷𒊩𒈝	NEA
𒁁𒄷𒍮𒁁𒄷𒍮	STB
𒉺𒆠𒀉	OLB
𒀭𒋗𒉌𒂂𒋗	SUX
𒀀𒈾𒈾𒍝𒅈𒌷𒆠	MPB
𒈗𒁁𒉌𒀀𒉌𒄑𒍝𒁁𒋢𒈗𒁁𒉌𒀀𒉌	NEB
𒌷𒂗𒅀	MPB
𒊹𒈠𒈾𒆬𒌓𒈛𒌋𒀸𒁓𒆠𒀭𒊹	NEA
𒌝𒈠𒀠𒋼𒈬𒌝𒈠𒈾𒀀𒀜𒋫	NEB
𒉆𒄩𒁀𒀭𒁕𒋻𒊒𒉈	SUX
𒇽𒆠𒀀𒀀𒀸𒉺𒀭𒈗𒂗𒐊	NEB
𒈗𒂗𒀀𒄿𒁲𒌌𒌅𒌋𒅗𒃻	NEB
𒌝𒈠𒈪𒉆𒈠𒅁𒁍𒍑	NEB
𒊹𒄑𒍣𒈾𒊷	OLB
𒍣𒂵𒊮𒀀𒋛𒊑	OLB
𒀀𒈾𒉡𒂄𒉡𒌑𒀀𒈾𒆕𒌍𒍢𒁍𒌅𒀀𒈾𒊩𒈠𒃮𒁉𒀀𒈾𒇽𒌋𒌋𒄠𒈬	LTB
𒀀𒈾𒈗𒁷𒌁𒆠	NEB
𒈗𒁁𒉌𒅀	NEB
𒊹𒊕𒊩𒆳𒈨𒌍𒊹𒌉𒊩𒃮	OLB
𒅇𒀸𒊮𒁉𒌌𒄴𒁲𒆷	NEB
𒊹𒁕𒀀𒈠𒀾𒌈𒃻𒁉𒈩𒋙𒉡𒊹𒑛𒌑𒍑𒀭𒋫𒅎𒋛𒁲𒁕𒈨𒌍𒉺𒅆𒌈𒃻𒂍𒈬𒈨𒌍𒊹𒑛𒌑	LTB
𒁼𒁉𒄀𒈾𒁕	SUX
𒄷𒊒𒈠𒀀	NEA
𒇺𒆲𒆳𒅈𒊓𒍝𒀀𒀀	NEA
𒋗𒈬𒊭𒇽𒈨𒌍𒀀𒅀𒁉𒂊𒊭𒈗𒄿𒈾𒊮𒁉𒁾𒁉	MPB
𒉺𒀀𒇉𒀀𒋩𒀸	OLB
𒅔𒅆𒊒	SUX
𒀀𒁺𒌋𒀸𒋗𒊹𒃻	NEB
𒂊𒈬𒄣𒃻𒆳𒀸𒋩	NEB
𒌉𒀭𒊩𒌆𒄢𒈾𒆤	SUX
𒂍𒊮𒄭𒂵	SUX
𒁹𒅆𒇲𒋙𒁹𒆠𒈲𒀭𒀝𒃻𒀭𒀝𒉪𒋢	STB
𒀸𒌓𒊹𒌓𒊹𒅇𒌓𒊹𒄑𒊒𒁀𒇽𒆭𒂍𒌑𒌓𒈬𒈨𒌍	LTB
𒀀𒋫𒈾𒀾𒋙𒌷	NEA
𒂗𒊩𒆳𒋫𒁕𒉌	NEA
𒈦𒈠𒋗	MPB
𒀭𒈗𒀉𒄭𒂵𒋗	SUX
𒈨𒌍𒅀	MPB
𒄊𒊑𒅎𒀭𒅎𒈠𒍝𒊍𒁀𒁉𒅎	OLB
𒄿𒈾𒈠𒋾𒄿𒇻𒊺𒂊𒈾𒄩𒀠𒆪𒈠𒀀𒈾𒆪𒅟𒅈𒊏	STB
𒊭𒂍𒄷𒄭𒀀	OLB
𒀴𒅟𒇽𒄘𒂗𒈾	NEB
𒁹𒌅𒌋𒅀	MPB
𒄊𒀭𒌓𒄴𒀀𒁀𒀸	OLB
𒆷𒌑𒊺𒍦𒉡𒍝𒁉𒀉	NEA
𒁹𒀀𒄭𒈠𒊭	OLB
𒃻𒈾𒈨	SUX
𒃮𒁉𒃻𒀀𒈾𒅆𒅔𒍣𒊒𒌑	LTB
𒂍𒌌𒀀	NEB
𒁕𒄩𒆷𒌋𒊹𒋀𒋙𒊹𒑛𒌑𒍑𒆠𒌑𒅎𒍇𒇻𒁕𒂍𒅎𒋛𒁲	LTB
𒀀𒈨𒌍𒀸𒄷𒌓𒊮𒁉𒋙𒉡𒊩𒋙𒃻𒌓𒈬𒀸𒌓𒊹	LTB
𒆜𒈨𒌍𒋗𒊭𒍑𒅆𒅕𒋫	MPB
𒄿𒉡𒈠𒉿𒆷𒀝𒁹𒀀𒈠𒀭𒀊𒉺	MPB
𒁹𒀭𒀀𒀀𒉿𒁮𒁶𒇷	OLB
𒄿𒅟𒀠𒄩𒍣𒊑	MPB
𒆍𒃲𒌷𒅀𒇽𒉽𒄿𒈾𒃼	STB
𒊭𒀀𒈾𒁲𒂊𒅎	OLB
𒀸𒆠𒅆𒌨𒀜𒋙𒌀𒌉𒈗𒃻𒁹𒉆𒈗𒆷𒍠𒊒	STB
𒅗𒉈𒄀𒅔	SUX
𒀊𒁍𒈾𒈠	MPB
𒈨𒐐𒈦𒌑𒍑	STB
𒁾𒁹𒁹𒁹𒁹𒁹𒁹𒁹𒁹𒈠𒀠𒆪	STB
𒇽𒈬𒈥𒊩𒋡𒀭𒉡	LTB
𒀭𒊩𒌆𒉺𒀯	SUX
𒀭𒅀𒀭𒌓𒅀𒅇𒁍𒄩𒀜𒅖𒄭𒌅𒌷𒄩𒍣𒆠	MPB
𒈗𒁁𒉌𒀀𒆠𒄿𒅖𒈬𒌑	NEB
𒋾𒈪𒌅𒈾𒉡	MPB
𒌦𒋡𒁹𒌑𒁇	LTB
𒁳𒁍𒌑𒀀𒀉𒋾𒋙𒄿𒈾𒉺𒀭𒈗𒄿𒁀𒀾𒅆	NEB
𒊩𒈨𒌍𒄿𒊑𒆷𒆪𒈠𒄯𒋙	STB
𒊹𒊹𒉣𒇬𒆸𒈠𒀭𒂄𒉺𒌓𒁺𒀸𒊮𒋙𒁺𒄑	STB
𒃻𒌉𒃻𒀀𒃻𒀀	LTB
𒅇𒀭𒊩𒌆𒅁𒀀𒁉	OLB
𒊹𒋼𒋙𒈧𒀲𒆳𒄩𒀀	STB
𒉋𒄀𒊺𒉇	SUX
𒅖𒌅𒂍𒀀𒉈𒊷𒆠𒌒𒇴	OLB
𒀀𒀀𒈾𒌓𒈬𒍝𒀀𒌓𒀉𒋫𒁷𒆬𒌓𒀀𒀭𒊹𒂆𒉚𒂍𒋢𒃻	LTB
𒀀𒉡𒈠𒀀𒈾𒆪𒋡𒁺	MPB
𒇽𒈾𒁷𒈾𒂍𒌋𒆠𒊒𒁀𒀀𒈬𒈨𒌍	LTB
𒁹𒀭𒈹𒈬𒆚𒇽𒋃𒌉𒃻𒀀𒀕𒆠𒌗𒉈	LTB
𒃻𒄀𒅖𒊒𒄿𒈾𒇻𒅟𒉡𒌝𒈠	NEB
𒊭𒊹𒈠𒈾𒍏𒈨𒌍	NEA
𒇷𒋗𒌋𒅗	MPB
𒐕𒌉𒃻𒊹𒌉𒃻𒊹𒀀𒈨𒌍𒁹𒋀𒀪𒌑𒌅𒊹𒌉𒃻𒊹	LTB
𒈾𒁕𒋼𒆪𒉌𒇻𒋫𒄭𒁉	NEA
𒈾𒄰𒌈𒌓𒀕𒆠	OLB
𒌌𒄠𒈥𒀀𒁲𒀀𒈾	NEB
𒀴𒈨𒌍𒃻𒈗𒃮𒁉	NEB
𒊭𒁺𒀀𒆠𒀀𒈾𒆪𒆷𒀀𒃻𒁄𒇻𒁲𒀀𒈾𒆪	NEA
𒃻𒋗𒀭𒀫𒌓𒈬𒊭𒅆	OLB
𒌉𒍑𒆗𒂵	SUX
𒇽𒈬𒋾𒀀𒁀𒀠𒈨𒌍	OLB
𒉡𒌌𒋼𒌍𒈬	NEB
𒁹𒀹𒁯𒆷𒈠𒍣	OLB
𒇽𒆳𒀀𒀀𒊭𒁁𒋼𒁁𒋼𒂊𒉌	NEA
𒋫𒂊𒋼𒇷𒉿𒋼	NEA
𒈫𒋗𒈨𒂖𒇷𒈬𒂖𒆷𒅊𒅊	SUX
𒄿𒉆𒁷𒈨𒌍𒀀𒈾𒇽𒁮𒈨𒌍𒌋𒊹	LTB
𒀀𒃻𒀀𒈨𒌍𒀀𒈾𒌓𒈬𒍝𒀀𒌓𒅆𒄿	LTB
𒅋𒋃𒌋𒉌𒌓	NEA
𒀀𒉿𒅔𒂟𒂵	SUX
𒁲𒋻𒀀𒈾𒋗𒉌𒌈𒁄𒂊𒀀	SUX
𒌉𒃻𒀀𒈾𒌓𒈬𒍝𒀀𒌓𒈾𒋗𒌑𒊹	LTB
𒈬𒂦𒈣𒌷𒆠𒅇𒂷𒀠𒄄𒀀𒆠𒈬𒌦𒄢𒂊	SUX
𒉎𒁉𒆳𒊮𒂵	SUX
𒊹𒅇𒊹𒈠𒀝𒋫𒋼	MPB
𒃻𒊹𒌉𒃻𒈨𒌍𒉺𒃻𒉌𒌈𒃻𒂍𒈬𒈨𒌍𒊹𒌑𒍑𒀭𒌑𒅎𒈥𒌅𒁕𒆠𒊒𒁀𒀀	LTB
𒇷𒇷𒆪𒉌𒂊	NEA
𒀀𒈾𒌋𒅗𒄭𒂗𒉌𒇻𒌑𒂄𒈬	MPB
𒌉𒃻𒀸𒄷𒌓𒊮𒁉𒋙	LTB
𒄿𒈾𒋆𒋾𒃻𒈗𒁁𒉌𒐊	NEB
𒌉𒄿𒉡	OLB
𒅇𒀀𒈾𒈠𒊍𒇡𒋾	NEB
𒀀𒋡𒁉𒈾𒂇𒊭	NEA
𒄿𒈾𒌋𒈬𒌓𒊹𒉈𒋫𒊹𒊐	STB
𒈗𒂗𒅀𒀭𒌓𒅀	MPB
𒄿𒉆𒁷𒁍𒌑𒌓𒈬𒊒𒄣𒃻𒂍𒅇𒌑𒉡𒌑𒌓𒈬𒈨𒌍𒊹	LTB
𒄭𒁉𒂉𒌑𒊭𒄠𒋡𒀜𒋫𒁀𒃼𒈾𒋙𒃻𒈠𒈪	STB
𒅇𒉿𒅁𒆠𒀉𒉌𒄿𒈾𒋗	MPB
𒉌𒌓𒈬𒁉𒈹𒀀	SUX
𒄿𒅀𒉡𒆷𒀀𒁖𒆷𒁕𒀀𒈾𒀀𒈠𒋼𒈨𒌍𒊭𒋼𒅁𒁍𒍑𒌌𒌅𒉺𒈾𒉡	MPB
𒀭𒅊𒀭𒁁	SUX
𒀭𒂗𒀭𒉺𒀀𒈾𒈗𒂗𒅀𒌨𒊒𒁍	NEA
𒅔𒄖𒊑	NEA
𒅇𒉌𒋛𒅔𒈾𒍣𒂵	OLB
𒅇𒊮𒌓𒈨𒌍𒋰𒁉𒋗𒉡	OLB
𒀀𒈾𒊓𒊒𒌷𒆠	MPB
𒌑𒄭𒉡𒉌𒌓𒍝𒆳𒍣𒌋𒌋𒍪	MPB
𒌋𒀸𒀸𒀸𒀸𒀸𒄘𒌦𒆬𒌓𒊹	SUX
𒀭𒄠𒈠𒆳𒅕𒍢𒌅	SUX
𒈗𒄯𒊕	SUX
𒇯𒁺𒀉𒉈𒁕𒀊𒋫	STB
𒊭𒅟𒊍𒇷𒇻𒀴𒋫𒄩𒊩𒈠	STB
𒀭𒀫𒌓𒅆𒊹𒌉𒃮𒋫𒊑𒅖𒈠𒌈	OLB
𒌗𒄞𒋛𒁲𒌓𒊹	OLB
𒉆𒄩𒅈𒋾𒋫𒊑𒁍𒌝𒇽𒃡𒊏	OLB
𒀀𒈾𒉺𒉌𒆪𒉡𒀀𒉺𒅁𒉺𒆜𒋙	NEB
𒀭𒂗𒉣𒂼𒆷𒋗	SUX
𒁲𒅔𒋙𒇷𒁍𒋗	NEA
𒌷𒄯𒁉	SUX
𒋙𒌑𒆗𒌒𒌓	STB
𒀭𒁄𒉺𒉺𒊓𒉡𒉡𒌉𒀭𒈽𒆤	SUX
𒌝𒈠𒇽𒂟𒈨𒌍𒋫𒁲𒅅𒆠	NEB
𒀀𒈾𒈗𒁁𒉌𒀀	NEA
𒌓𒁀𒋛𒅇𒌝	SUX
𒀀𒉡𒌝𒈠𒈪𒊑𒅖𒌈	MPB
𒃻𒈗𒆳𒉏𒈠𒆠𒀀𒈾𒉺𒉌𒉌𒀉𒊑𒆪	NEB
𒋫𒊑𒁍𒌝𒀴𒀭𒀭	OLB
𒊭𒈗𒂗𒀀𒂊𒋰𒋙𒀸𒋗𒊹𒐊	NEA
𒂊𒊏𒁀	NEA
𒊹𒄑𒃡	OLB
𒊹𒊹𒀸𒅆𒇲𒋙𒌑𒉺𒅁𒉈𒈠𒅆𒅕	STB
𒅆𒋻𒃻𒂍𒈬𒈨𒌍𒊹𒌑𒍑𒆠𒌑𒅎𒆳𒊏𒄘𒀀𒇉	LTB
𒌉𒊕𒀭𒀏	SUX
𒀀𒄭𒃻𒆳𒄿𒉌𒆠𒅖𒋗𒌑	NEB
𒈠𒀀𒊹𒈾𒍦𒀭	NEA
𒆷𒌅𒃻𒆗𒊭	NEA
𒀸𒄷𒌓𒊮𒁉𒋙𒅆𒅔𒍣𒊒𒌑𒃻𒌓𒈬𒀸𒊹𒌓𒈬𒀸𒈪𒋻𒀸𒌓𒊹	LTB
𒋗𒁹𒀭	MPB
𒆬𒄀𒊏𒁉𒌅	MPB
𒋧𒈬𒊹𒁀𒆷𒋢	NEA
𒃻𒌓𒈬𒀸𒊹𒌓𒈬𒋫𒌓𒊹𒂗𒌓𒊹𒋾𒋗𒌑𒃻𒌓𒈬𒀸𒊹𒌓𒈬𒋫𒌓𒊹𒂗𒌓𒆚	LTB
𒀭𒃽𒆃𒀭𒈾𒋗𒊹𒄞𒁆𒀭𒇡𒉺𒉌𒌈𒆤	SUX
𒇴𒉡𒌝𒀀𒈾𒉺𒉌𒅟𒂗𒅀	MPB
𒉺𒉡𒆳𒄣𒁕𒀾𒁍	STB
𒆳𒀀𒁓𒊕𒍑𒊭𒀊	STB
𒀸𒌷𒁉𒊏𒈾𒀀𒌈𒃮𒆍𒃲𒀭𒈩𒇴𒋫𒌓𒁺𒀀𒉆𒀕𒆠𒊹	LTB
𒀀𒁲𒂊𒀀𒈾𒌉𒊹𒅀𒁺𒌓𒌁𒀀𒈾𒆪	NEB
𒊭𒌷𒈨𒌓	NEA
𒄑𒂞𒁁𒈨𒌍𒆳𒊒	NEA
𒆠𒂗𒄀𒆠𒌵𒀀	SUX
𒀀𒈾𒊹𒈠	NEB
𒆳𒉽𒋫𒍝𒄒𒀭𒅎𒊏	STB
𒊭𒄿𒈾𒁉𒅕𒆠𒅎	OLB
𒃻𒆠𒋀𒈨𒌍𒋙𒌋𒂗𒈨𒌍𒄩𒆷𒈨𒌍𒋙𒃮𒁉𒃻𒌗𒊻𒋢𒌋𒈬𒀭𒈾𒊻𒋢	LTB
𒍣𒂊𒌷𒋙𒌓𒈬𒈨𒌍𒃻𒊒	STB
𒉺𒉡𒋫𒌑𒉺𒀪𒄿	MPB
𒊹𒀯𒀸𒁁𒈲𒄩𒌇𒅆𒉡𒅆𒂟	STB
𒊹𒅇𒂍𒆠𒊒𒁀𒀪𒈨𒌍𒈬𒈨𒌍𒂍𒅇𒆠𒊒𒁀𒀪𒈨𒌍𒈬𒈨𒌍𒄿𒍢𒌋𒈠𒁕𒈠𒆷	LTB
𒄿𒈾𒊮𒁉𒄿	NEA
𒃻𒈗𒁁𒉌𒅀𒇷𒅅𒁍𒌑	NEB
𒊑𒄷𒄭𒌑𒌓𒀀𒈾𒀀𒃻𒀀	LTB
𒊩𒌆𒃶𒌌	SUX
𒊹𒊩𒊕𒈨𒌍	OLB
𒊭𒀸𒌋𒅗𒇽𒀴𒈨𒌍𒊭𒊹𒀭𒅀𒁕𒀪	NEA
𒄑𒊒𒁀𒋙𒉡𒅆𒀭𒃽𒂔𒃻𒀸𒄑𒊬𒄬𒆳𒃻𒌗𒊻𒋢	LTB
𒃻𒀸𒊕𒁺𒋙𒊕𒉡𒈠𒀀𒈾𒉺𒀭𒈗𒂗𒅀𒅋𒇷𒆪𒃻𒊹𒊑𒌋𒌋𒉌𒀭	NEB
𒅟𒀠𒄖𒂵𒊹𒂆𒅔	STB
𒁹𒅁𒉌𒀭𒆏𒋫	OLB
𒋾𒋙𒉡	NEB
𒅅𒋫𒁀𒀀𒂄𒈬	NEB
𒄿𒁲𒉌𒋗𒀴𒀀𒈾𒈗𒊑	MPB
𒀭𒈨𒌍𒌋𒈗𒋗𒆸𒆸𒊹𒌑𒍑𒊹𒌑𒊕𒆠𒈪𒋚𒌈	LTB
𒆳𒂊𒉡𒅍𒂊	SUX
𒄀𒌋𒄭𒈬𒌒𒌓𒀀𒇉𒈨𒌍𒈬𒆥𒈾𒄫𒌓𒆳𒀀𒇉𒈨𒆠𒋼𒄈𒋰𒌓𒁴	STB
𒃻𒉿𒄿𒋙	STB
𒉺𒊩𒍑𒁇𒈨𒌍	OLB
𒆠𒂍𒅟𒋙𒄿𒉆𒁷	STB
𒀫𒀭𒄌𒆠	SUX
𒀀𒈾𒀴𒋙𒆠𒄿𒀭𒉌𒂊𒄿𒊓𒀊𒊏	NEA
𒀖𒍣𒁕	SUX
𒊮𒊑𒁺𒁴𒊭𒂍𒀀𒁁𒂖𒉌𒉌𒌑𒇥	OLB
𒌗𒊺𒆥𒋻	SUX
𒌋𒁕𒈬𒍮𒌑𒃻𒆠𒊒𒁀𒀀𒀀𒃻	LTB
𒌝𒈠𒀀	NEB
𒀉𒋫𒁷𒅇𒀀𒈾𒈗𒆳𒉏𒈠𒆠𒅋𒋰𒊏𒌝𒈠	NEB
𒀀𒆗𒌋𒌋𒈠𒀪𒁺𒀀𒈾𒂦𒈗𒁺𒆠	NEA
𒁁𒉌𒋙𒄴𒂅𒌑𒆠𒄿𒌦𒁹𒅆𒊒𒈪𒄿𒋾	NEB
𒀀𒈾𒀀𒃻𒁉	NEB
𒉌𒉌𒌦𒉈𒉌𒇷𒆠	OLB
𒌒𒆷𒀸𒋗	OLB
𒀀𒈾𒇽𒃡𒊏	OLB
𒇽𒋢𒌅𒌝	OLB
𒊹𒀯𒊕𒈨𒃻𒀸𒆜𒋗𒌓𒀭𒂗𒆤𒁺𒈠𒂟𒋙	STB
𒀭𒈗𒄈𒃡𒊏	SUX
𒃻𒉿𒅕	NEB
𒂗𒅀𒅖𒌅𒉺𒈾𒉡𒌝𒈠	MPB
𒊩𒉌𒁷𒌈	LTB
𒀸𒂍𒅟𒊑𒀀𒉺𒅁𒉺𒊏	NEA
𒀭𒋛𒊑𒄑𒋆𒀭𒋛𒊑𒄑	STB
𒌋𒌉𒈨𒌍𒃻𒌉𒃻	LTB
𒀜𒈬𒌑𒆠𒂊𒉡𒀸𒅟𒌦𒈨𒌍𒃻𒀭	STB
𒅇𒍑𒅆𒅕𒁹𒈗𒊒	MPB
𒄈𒇲𒀭𒊩𒌆𒄈𒋢𒅟𒊏	SUX
𒀉𒊑𒆪𒌋𒉌𒈜𒁍𒌑𒊓𒀾𒆠𒅔𒋙𒉡	NEA
𒊹𒌓𒈬𒉺𒋡𒊑𒀀𒈾𒌋𒅗𒄭𒆠𒊒𒁀𒀀𒈬𒈨𒌍𒀉𒋰𒋗𒌑𒈠	LTB
𒋗𒈝𒃻𒁁𒉌𒅀	NEB
𒁹𒍣𒅕𒉺𒀀	OLB
𒁹𒁹𒁯𒂗𒉆	SUX
𒈬𒊹𒌋𒁹𒋛𒇻𒆪𒈗𒈨𒌍	LTB
𒌓𒊹𒈬𒊹𒁹𒀭𒋾𒀪𒄿𒆪𒋢𒈗𒀸𒀕𒆠𒀸𒄷𒌓𒊮𒁉𒋙𒉡	LTB
𒆠𒄿𒇽𒀀𒈨𒊑𒅟	NEB
𒊒𒁴𒌦𒈨𒌍	STB
𒀭𒈨𒌍𒆳𒌵𒆠𒁹𒅆𒂟𒁴	STB
𒊑𒇷𒆪	NEB
𒈗𒄑𒆵𒆠	SUX
𒅋𒄖𒉌𒋗𒌝𒈠𒀉𒋫𒀠𒁀𒀸𒊭𒄠𒈾	STB
𒂵𒀊𒂍𒆳	NEB
𒁮𒌉𒉈𒉈	SUX
𒀭𒍝𒂷𒂷	SUX
𒌑𒈠𒀀𒌑𒊓𒉌𒀪	NEA
𒁹𒅟𒀠𒇻𒍝	OLB
𒈗𒁁𒉌𒇺𒀪𒀠𒋙	NEA
𒅆𒊹𒀭𒌓𒀖𒀀𒉌𒇽	NEA
𒅇𒊭𒊑𒅀	MPB
𒃻𒋗𒀭𒊩𒌆𒅁𒈠𒀭𒋧	OLB
𒀀𒈾𒈬𒌨𒄣𒃻𒄩𒆷𒋙𒉡𒀀𒈾𒌓𒈬𒍝𒀀𒌓𒈾𒋗𒌑𒈠𒄠𒃻𒊑𒅅𒋢𒃻𒁕𒊑𒀭𒈾𒀀𒌑𒃻𒀭𒉡𒌑	LTB
𒅋𒆷𒅟𒀀𒆳𒋢𒀀𒈾𒉿𒄿𒋙	NEB
𒆥𒀀𒁺𒁀𒁀𒅟	SUX
𒊹𒊹𒉣𒇬𒆸𒈠𒀯𒉼	STB
𒀭𒌓𒈗𒁁𒉌𒅀𒇷𒇷𒃮𒁉𒋗𒉡	MPB
𒁲𒈬𒀀𒈾𒌷	NEB
𒀀𒉡𒈠𒄿𒈾𒈾𒉺𒉡𒅟𒇷	MPB
𒊭𒂍𒀀𒁁𒂖𒉌𒉌𒌒𒇴	OLB
𒁹𒋀𒀪𒌑𒌅𒌉𒃻𒁹𒇻𒍑𒌓𒈥𒀭𒅎𒌉𒃻	LTB
𒅇𒉿𒂖𒈠𒀜	MPB
𒃻𒀸𒂍𒀊𒃲𒂍𒊑𒌍𒅇𒂍𒀀𒆠𒌈𒈨𒌍𒀀𒈾𒄀𒉡𒌑	LTB
𒃻𒀀𒈾𒄑𒊒𒁀𒇽𒆭𒂍𒌑𒌓𒈬𒈨𒌍𒅅𒁉𒅆𒁺𒀉𒋾	LTB
𒈗𒆳𒆷𒋗𒀀𒋾	STB
𒊹𒌋𒁹𒀭𒈾𒈾𒀀𒈬𒋀𒈨𒌍𒋙𒌉𒈨𒌍𒃻𒊹	LTB
𒋳𒈾𒈗𒆳𒀸𒋩𒆠	STB
𒅋𒇷𒆠𒀀𒄠𒈠	OLB
𒀀𒈾𒆪𒈗𒁁𒉌𒀀𒉌	NEB
𒁹𒊑𒅁𒀜𒁲𒆠𒅟𒉡𒅖𒌅	MPB
𒀀𒈾𒈗𒂗𒐊	NEB
𒊹𒇽𒀀𒋛𒀸	OLB
𒌉𒃻𒀀𒃻𒀀𒀸𒄷𒌓𒊮𒁉𒋙	LTB
𒁹𒆰𒅀𒀀𒈾𒌉𒃻𒌉𒃻𒌉𒃻𒀀𒈾	LTB
𒃻𒊹𒌋𒊹𒌉𒈨𒌍𒃻𒁹𒀭𒈾𒈾𒀀𒈬	LTB
𒂍𒀭𒂼𒃾𒈾𒅟	SUX
𒉆𒊩𒆳𒉌𒂠𒅇𒃻𒁀𒉌𒂠	SUX
𒁹𒀀𒇷𒀀𒀜𒀹𒁯	OLB
𒊹𒌉𒃻𒆠𒌉𒃻	LTB
𒀀𒃻𒀀𒀸𒄷𒌓𒊮𒁉𒋙	LTB
𒋗𒆪𒅆	OLB
𒊭𒄀𒅖𒉌𒉌𒉺𒂍	OLB
𒅗𒂍𒃲𒋻𒆷𒌓𒈲𒈨𒌍𒈫𒈠𒇻	STB
𒆗𒈬𒀭𒈾𒈨𒌍𒄖𒊌𒋡𒉌𒂊𒌓𒀊𒀊𒈨𒌍𒌋𒊩𒈠𒃮𒁉	LTB
𒅇𒈬𒋾𒀭𒁕𒃶𒉺𒍑𒁇𒈨𒌍	OLB
𒀀𒇉𒂗𒌶𒃲	SUX
𒌑𒆠𒅔	STB
𒌉𒀭𒂗𒍪𒂵𒅖	OLB
𒊕𒆠𒆠𒋫	LTB
𒊹𒀭𒀝𒈬𒀳𒌍𒇽𒄘𒂗𒈾𒋗𒊹𒋢	NEB
𒁹𒅁𒆠𒀉𒀭	OLB
𒊹𒃻𒌓𒈬𒃻𒅆𒅖𒋙𒀸𒊹𒃻𒌓𒈬𒃻𒀸𒄑𒊒𒁀𒇽𒈬𒌑𒌓𒀸𒌓𒊹𒈬𒈨𒌍	LTB
𒀀𒈾𒂍𒃲𒊍𒉺𒅁𒊏	NEA
𒆬𒂵𒋗	SUX
𒁹𒁁𒋾𒀭𒀀𒈾𒄊𒈨𒌍𒂗𒉌𒉌𒄠𒋻	MPB
𒄿𒁕𒀀𒆠𒁹𒌋𒅗𒃻𒃻𒋃𒐊	NEB
𒅇𒀸𒋰𒁇𒇽𒆥𒅀𒀀𒈾𒈗𒁁𒅀	MPB
𒃾𒆷𒀪𒌑𒌋𒃾𒈨𒌍𒃻𒋫𒈦𒄭𒇷	STB
𒀀𒈾𒉺𒀭𒈗𒁁𒉌𒅀𒀀𒉺𒅁𒊏𒋙𒉡	NEA
𒌑𒊹𒂆𒆬𒌓𒀀𒋻𒋧𒋢	LTB
𒊹𒊕𒊩𒆳𒈨𒌍𒊮𒊭𒀠𒆷𒀜𒉌𒋛𒅔𒆠	OLB
𒀀𒈾𒆪𒅇𒌉𒈨𒌍𒅀	MPB
𒀮𒆷𒊍𒌅	MPB
𒄿𒆥𒁀𒋙𒉌𒈠𒀀𒋳𒈠	NEA
𒀀𒈾𒊹𒈦𒈠𒈾𒆬𒌓𒋡𒇻𒌑𒄑𒋫𒌁𒊏𒉡𒃻𒁹𒀭𒋾𒀪𒄿𒆪𒋢	LTB
𒀀𒈾𒉺𒉌𒀭𒊮𒊭𒀠𒆷𒀜𒉌𒋛𒅔𒆠	OLB
𒀭𒆷𒁇𒉣𒇬𒈠𒋗	SUX
𒌓𒊹𒆚𒅆𒇲𒈠𒅆𒌨𒆳𒌵𒆠	STB
𒀸𒌋𒅗𒊹𒀭𒀝𒁀𒃻𒆷𒀾𒁓	NEA
𒀀𒈾𒈾𒀾𒌓𒋾	NEB
𒌅𒈜𒋥	STB
𒉆𒊑𒅕𒊒𒃻𒊒𒊒	STB
𒌷𒈗𒀀𒈾𒊭𒀀𒋗𒅇	MPB
𒁹𒀊𒁲𒀹𒁯𒇽𒋢𒂔𒆠	OLB
𒂼𒋓𒁓𒆷𒆠𒊏	SUX
𒅆𒊹𒈥𒆗𒉡	NEA
𒈾𒀾𒌌𒄿𒊩𒆳𒂅𒈠𒊹𒈬𒈨𒌍𒄑𒊒𒁀𒈬𒈨𒌍	LTB
𒋫𒅆𒊹𒋃𒀭𒊹	NEA
𒉌𒉌𒄿𒊬	SUX
𒀭𒈹𒀭𒈾𒈾𒀀𒀭𒃽𒃻𒊕𒀭𒊬𒊏𒀀𒄭𒌈𒌋𒀭𒈨𒌍𒂍𒋙𒉡𒃮𒁉	LTB
𒁹𒁀𒊍𒋛𒅀	LTB
𒊹𒍜𒄭𒀀𒃻𒍝𒇴𒈗𒈨𒌍𒃻𒀸𒌓	LTB
𒁀𒉌𒅀𒌈	MPB
𒀀𒃻𒀀𒌑𒈥𒊩𒈠𒀀𒁲𒊹	LTB
𒁕𒆠𒊒𒁀𒀀𒃻𒌉𒃻𒊹𒌑𒍑𒆠𒌑𒅎𒍇𒇻𒁕𒈨𒌍𒉺	LTB
𒁹𒈬𒈾𒉿𒅕𒌈	OLB
𒁉𒀀𒋼𒊭𒈗𒂗𒅀	NEA
𒅆𒉿𒅕𒋾	NEB
𒋗𒈬𒁕𒄫𒂊	SUX
𒊹𒌉𒃮𒌉𒀀𒂵𒀠𒀀𒈾𒁁𒂖𒋾𒅀	OLB
𒊹𒀯𒋗𒄀𒆳𒆳𒊒𒋙𒄿𒉆𒁍𒌓	STB
𒀀𒆠𒊭𒈗𒂗𒉌𒄿𒆷𒀪𒌋𒉌	NEA
𒁹𒉌𒁷𒌈𒀭𒈹𒌉𒃻𒊹𒌑𒍑𒆠𒌑𒅎𒆳𒊏𒁕𒂍	LTB
𒉡𒌒𒅆𒌈𒄄𒄄𒀀	SUX
𒌋𒈨𒉌𒆕	SUX
𒃻𒄑𒊒𒁀𒈨𒌍𒌋𒊹𒀀𒈾𒁹𒀭𒌓𒈬𒉡	LTB
𒄿𒈾𒆳	STB
𒊹𒃷𒀀𒊮𒍤𒆸𒊺	SUX
𒅇𒄿𒂵𒊓𒁺𒉏	MPB
𒀸𒈪𒊭𒌓𒊹𒄰	NEA
𒅇𒈪𒉡𒌝𒉿𒅅𒋫𒁍	MPB
𒀭𒅘𒋫	SUX
𒊹𒌓𒊹𒆚𒊹𒌋𒊹	STB
𒊩𒁍𒀪𒄿𒌈	LTB
𒃻𒀀𒊒	STB
𒊮𒊹𒇽𒀀𒋛𒊑	OLB
𒂍𒌉𒍑𒉡𒌇	SUX
𒀭𒊓𒈨𒈫	SUX
𒁹𒁷𒋻𒊐𒋙𒈬𒋳𒀭𒈨𒌍𒌋𒈗	LTB
𒀕𒆠𒄀	SUX
𒅅𒁉𒅆𒁺𒃻𒆠𒋀𒈨𒌍𒋙𒅇𒂗𒈨𒌍𒄩𒆷𒈨𒌍𒋙	LTB
𒌑𒌌𒆠𒉺𒈾𒉡𒅟𒇷𒆳𒆳𒈨𒌍	MPB
𒆠𒊒𒁀𒀀𒈬𒈨𒌍𒌉𒃻𒊹𒊹𒈦𒌑𒊕𒆠	LTB
𒁁𒂖𒋗𒉡	OLB
𒊹𒊹𒀸𒅆𒇲𒋙𒂇𒀀𒌓𒊕𒍑𒈠	STB
𒊹𒂗𒇽𒄷	NEA
𒀭𒂗𒍪	OLB
𒌅𒂟𒁁	STB
𒋫𒈨𒌓𒀭𒉌𒌓𒀸𒊮𒁉𒍜𒈨𒌍𒆪𒉡	STB
𒌨𒀭𒌉𒍥𒁕	SUX
𒈾𒁷𒂍𒈬𒈨𒌍𒈬𒈨𒌍	LTB
𒇽𒈬𒁺𒊹	LTB
𒇽𒊕𒉡𒃻𒀉𒋾𒊹	NEB
𒄑𒊒𒁀𒋙𒇽𒋋𒌑𒌓𒅆𒊹𒀭𒌈𒀭𒈾𒈾𒀀𒀭𒃽𒃻𒊕	LTB
𒈠𒀀𒌷𒄬𒍮𒇻	NEA
𒉺𒈥𒌅𒈨𒌍𒅇𒀀𒄭𒀀𒁴	OLB
𒊭𒀀𒁲𒉌𒆷𒅟𒀭𒆪	OLB
𒅇𒈾𒅗	SUX
𒀀𒈾𒊹𒋀𒋙𒉡𒀀𒈾𒌓𒈬𒍝𒀀𒌓𒀸𒀭𒁷𒀪	LTB
𒀭𒂠𒍣𒁕	SUX
𒇽𒋃𒀀𒃻𒀀𒀕𒆠	LTB
𒌉𒃻𒀀𒅇	LTB
𒁀𒂶𒀀	SUX
𒀴𒊭𒊑𒅎𒀭𒀀𒉡𒌝	OLB
𒊺𒆰𒍠𒉿𒌋𒅟𒂄𒁍𒊺𒆰𒈬𒈨𒌍𒄿𒍢𒌋𒈠𒀀𒁺𒈠𒆷𒁀𒋗𒌑	LTB
𒁹𒊓𒀀𒈬𒌝	OLB
𒈠𒄯𒁹𒀀𒈠𒀭𒄩𒀜𒁉𒄿𒊑𒁍𒈾	MPB
𒃻𒋗𒅍𒆷𒁀	SUX
𒂗𒈾𒄠𒈨𒉌𒄿𒊹𒂗𒆕𒃼𒌨𒁁𒈠	NEB
𒋫𒈠𒊏𒊍𒈠𒆠𒄿𒋡𒀜𒉺𒉌𒈠	STB
𒀀𒈾𒊩𒁍𒀪𒄿𒌈𒄿𒉆𒁷𒁍𒌓𒆷𒇽𒂡𒆪𒌑𒌓	LTB
𒌉𒇽𒀭𒈹	SUX
𒀸𒆪𒌦𒄿𒈾𒌷𒍮𒈬𒊑	MPB
𒋗𒋾𒀀𒉡𒊏𒌈	OLB
𒁹𒋫𒄴𒈠𒉿	MPB
𒄿𒀫𒀀𒈠𒊒	MPB
𒈝𒉌𒄿𒈾𒊮𒁉𒅟	MPB
𒀀𒈾𒆪𒀀𒁲𒋫𒊑𒋾𒅖𒌅𒀀𒈠𒋼𒂗𒅀𒆷𒀀𒉺𒀜𒋻	MPB
𒀭𒀀𒉡𒁍𒀭𒈥𒌅	SUX
𒅁𒉌𒀭𒂗𒍪	OLB
𒀭𒊩𒌆𒂍	SUX
𒂍𒆳𒈨𒌍𒊹𒌋𒌋𒄿𒍝𒈾𒀭	STB
𒊒𒊻𒍮𒉡𒈬	STB
𒉌𒋩𒊑𒂊𒉈	SUX
𒀭𒍣𒁀𒀭𒆠𒈫	SUX
𒄿𒊐𒁉𒍮𒁲𒅖𒂙𒁹𒂗𒋼𒈾	STB
𒊭𒈗𒂗𒅖𒁓𒀭𒉌𒈠𒀀𒌉𒊹𒅟𒊩𒆪	NEA
𒀸𒆳𒋛𒅔𒄀𒁍𒋾	NEA
𒀀𒈾𒊹𒈠𒈾𒉌𒌓𒄠𒈾𒆪	STB
𒀀𒈾𒁷𒍣𒈨𒌍𒃻𒈗𒁁𒉌𒄿𒉌	NEB
𒅆𒌓𒋾𒈗𒀀𒈾𒉺𒉌𒅀	NEB
𒉺𒈥𒌅𒈨𒌍𒀕𒆠	OLB
𒊹𒁹𒌑𒁇𒌉𒃻𒊹𒀀𒁹𒆳𒄿	LTB
𒀴𒆠𒀉𒋼	MPB
𒊮𒁀𒅟𒆷𒁺𒍑𒈠𒊏𒊍	MPB
𒃻𒌗𒊻𒋢𒆗𒈬𒀭𒈾𒄖𒊌𒋡𒉌𒂊𒌓𒀊𒀊𒈨𒌍	LTB
𒉺𒅈𒋛𒆳𒋾𒉌	NEA
𒊒𒁓𒊒𒋛	STB
𒁹𒀴𒂍𒊑𒌍	LTB
𒌌𒌅𒉌𒈿𒀀𒆠	NEB
𒊹𒊹𒂇𒌓𒋙𒋙𒊒𒀀𒌓	STB
𒀸𒌗𒍩𒌓𒊹𒀭𒈪𒊹𒃻𒈠𒊝𒋢𒆭𒀭𒅥	STB
𒀉𒋾𒅟𒄿𒈾𒁀𒀀𒁍	STB
𒊺𒋛𒈠𒉌	SUX
𒋗𒁹𒊑𒁉𒀭𒁕𒃶	MPB
𒀀𒈾𒌉𒃻𒈾𒋗𒌑𒅆𒅔𒍣𒊒𒌑𒃻𒌓𒈬	LTB
𒌝𒈠𒀀𒈾𒆪𒆠𒄿	NEB
𒊭𒀀𒈾𒆏𒄿	NEA
𒀭𒊩𒌆𒅟𒊷𒌜𒂍𒈤𒆤	SUX
𒄿𒁷𒌝𒈠𒆷𒋫𒁄𒈛	NEB
𒁹𒋗𒁍𒌌𒌈	OLB
𒋾𒅋𒋰𒊏𒀭𒉌	MPB
𒈜𒆥𒀉𒄑𒋛𒅀	NEA
𒅇𒊩𒌆𒃶𒅅𒁮𒀀𒉌	SUX
𒌉𒈨𒀀	SUX
𒊮𒊭𒀠𒆷𒀜𒉌𒋛𒅔𒆠	OLB
𒀀𒈾𒌋𒅗𒄭𒄿𒉌𒌑𒅟	NEB
𒆠𒌨𒆬𒍪𒋫	SUX
𒆷𒄣𒌨𒁀𒋾	NEA
𒀭𒌓𒌅𒋳𒌆𒈫	SUX
𒆷𒀀𒆪𒍑𒋙𒂗𒊩	NEB
𒂗𒉣𒆪𒉡𒇻𒆗𒈾𒀜	NEA
𒉈𒂊𒈨𒅖𒆲𒀭𒉌	NEB
𒌋𒇽𒍢𒊏𒉌𒂊𒀀𒈾𒉺𒀭𒇽𒃲𒈨𒌍	NEB
𒁹𒀴𒀀𒅆𒅕𒋫𒀀𒈾𒊭𒋗	MPB
𒀾𒊒𒂍𒀀𒄭	STB
𒊹𒊩𒈾𒁷𒈾𒀜𒆠𒊒𒁀𒀀𒈬𒈨𒌍𒀸𒋗𒈫𒀀𒃻	LTB
𒅇𒀭𒉡𒌑𒄿𒋡𒁍𒁁𒅀	MPB
𒀀𒈾𒈗𒁁𒉌𒅀𒀭𒈨𒌍𒅀𒀭𒌓𒅀	MPB
𒌗𒊺𒆥𒋻𒌓𒊹	OLB
𒆬𒄀𒊹𒀭𒊹𒋾𒋢𒅅𒁉	NEA
𒊹𒊹𒌓𒊹𒆚𒅆𒅕𒅟𒄀𒈾𒊮𒁉𒆳𒄭𒀊	STB
𒀀𒈾𒅀𒅆𒀀𒈾𒀀𒆷𒆠𒀀𒈾	MPB
𒁹𒊑𒉺𒀭𒈹	LTB
𒇻𒁉𒇻𒌋𒉌𒈗𒁁𒉌𒇺𒀠𒋙𒆠𒈠	NEA
𒊭𒅁𒉌𒀭𒈥𒌅𒇽𒉌𒋛𒅔𒆠	OLB
𒌝𒈠𒌋𒌋𒈠𒄷𒌒𒌅𒃻𒆳𒌵𒆠𒃻𒆷𒉡𒌑𒀀	NEB
𒊹𒆪𒈾𒀀𒈗𒆷𒌑𒈦𒊬𒀾𒋙𒇽𒈠𒀝𒌅𒋾	NEB
𒊹𒄑𒍎𒍠𒄖𒆷	SUX
𒉺𒉌𒈪𒇷𒃻𒀀𒇉	NEB
𒅇𒀸𒋳𒀭𒉌𒋾𒁹𒈠𒉌𒂊𒅅𒅟𒆷𒀀𒌑𒉺𒀀𒀭𒋀𒅀𒁹𒄀𒇷𒅀	MPB
𒀫𒍝𒆳	SUX
𒄖𒉌𒁺	SUX
𒀀𒆗𒁺𒄰𒆠𒈫𒀭𒌑𒋩𒉣	STB
𒌌𒉌𒄿𒁲	NEB
𒀴𒉌𒉌𒂗𒉆	SUX
𒊭𒁇𒈗𒀀𒈾𒈗𒌷𒇥𒄭𒀀𒆠	MPB
𒆏𒍪𒍪	MPB
𒊹𒌉𒌉𒊏𒌉	OLB
𒁹𒀭𒈾𒈾	OLB
𒇸𒇷𒅟	NEA
𒇽𒉡𒄑𒊬𒈨𒌍	NEA
𒌋𒀭𒈨𒌍𒂍𒈨𒌍𒋙𒉡𒃮𒁉𒃻𒌗𒊻𒋢𒆗𒈬𒀭𒈾𒄖𒊌𒋡𒉌𒂊	LTB
𒊺𒀭𒊩𒌆𒄈𒋢𒅟	SUX
𒇽𒄩𒆗𒈗𒄿𒉺𒅁𒊏𒈠𒀀𒈨𒌍𒉌	NEA
𒀀𒀀𒈾𒌓𒈬𒍝𒀀𒌓𒋗𒌑𒅎𒁾𒆠𒇴𒈨𒌍	LTB
𒃻𒊹𒀸𒌋𒅗𒃻	NEA
𒆏𒁉𒀀𒉿𒋾	MPB
𒂍𒉺𒉺𒄩𒃻𒀭𒌈𒍑𒆠𒌑𒅎𒍇𒇻𒁕𒂍𒉺𒉺𒄩𒃻𒀭𒃽𒃻𒂍𒊕	LTB
𒀭𒈫𒁄𒌺𒈫	SUX
𒀀𒉌𒉌𒆠𒄿𒊒𒌒𒁍𒋙	NEB
𒅇𒂖𒋾𒆪𒌷𒀸𒀸𒄭𒀀	MPB
𒌈𒋛𒀀𒁀𒇲	SUX
𒀭𒌦𒆠𒂗𒌺𒀭𒌍	SUX
𒇽𒆥𒄄𒀀𒊭𒊑𒅎𒀭𒂗𒍪	OLB
𒌗𒌓𒄰	OLB
𒃻𒂍𒌉𒃻𒊹𒌑𒍑𒆠𒌑𒅎𒍇𒇻	LTB
𒇽𒃻𒄣𒌑𒆠𒄿𒅋𒇷𒅟𒅅𒋫𒁉	NEB
𒊭𒀭𒂗𒍪𒂍𒆗𒇷𒉺𒇻	OLB
𒈬𒈨𒌍𒊹𒑛𒌑𒍑𒀭𒌑𒅎𒋛𒁲𒁕𒂍𒅎𒆳𒊏𒊹𒈪𒋻𒀸𒋻𒁀𒊍𒊹𒑛𒌑𒍑𒆠𒌑	LTB
𒌓𒊹𒈬𒊹𒁹𒉿𒇷𒉿𒄑𒈗𒆳𒆳	LTB
𒊭𒌨𒁍𒊏	NEB
𒌒𒋫𒀪𒌋𒉌𒈠𒈾𒆬𒌓	NEA
𒀭𒉌𒌓𒌑𒁲𒃻	NEA
𒌉𒄷𒍝𒈝𒌒𒀊𒉣𒈾𒆠	OLB
𒀭𒊩𒌆𒁈	SUX
𒊹𒊕𒆠𒆠𒋫𒅎𒆳𒊏𒁕𒂍𒌋𒊹𒈨𒌍𒉺𒃻𒈜𒌈𒃻𒋻𒁀𒊍𒃻𒂍𒈬𒈨𒌍	LTB
𒆠𒆳𒅴𒂠𒅇𒌵𒆠	STB
𒀴𒀭𒄿𒋳	OLB
𒇽𒉌𒋛𒅔𒈾𒆠	OLB
𒊭𒅖𒌅𒈠𒄩𒅈𒀭𒁕𒃶𒈠𒀭𒅋𒇷𒄰	OLB
𒀉𒋫𒁷𒆬𒌓𒀀𒀭𒊹𒂆𒉚𒆠𒊒𒁀𒀀𒈬𒈨𒌍𒌀𒈨𒌍𒁹𒀭𒈾𒈾𒀀𒈬	LTB
𒇽𒆷𒂵𒀸𒆠	OLB
𒊹𒌑𒍑𒆠𒆠𒋫𒅎𒍇𒇻𒁕𒀸𒋻𒌈𒃻𒈜𒌈𒃻𒂍𒈬𒈨𒌍𒊹𒌑𒊕𒆠	LTB
𒀀𒈾𒌷𒄬𒍮𒈨𒌍	NEA
𒌝𒈠𒁹𒍣𒀴𒅟𒈠	MPB
𒄊𒀭𒂗𒍪𒊑𒈨𒉌	OLB
𒊹𒀸𒊹𒌑𒇷𒊑𒆪	NEA
𒌷𒃻𒈗𒂗𒐊	NEB
𒀀𒈾𒈗𒁁𒉌𒅀𒌨𒊒𒁍𒀸𒌋𒅗𒊹𒊏𒄭𒄑𒌋𒌋	NEA
𒀀𒈾𒈗𒂗𒉌𒀭𒉺𒀭𒀫𒌓	NEA
𒀭𒊹𒀭𒌓𒅇𒀭𒀫𒌓𒀀𒈾𒈗	NEB
𒅇𒀀𒈾𒇽𒈨𒌍𒄤𒈨𒌍𒋾𒉌𒅁𒋗𒈗	MPB
𒀸𒌷𒊓𒁀𒄩𒉌	NEA
𒈠𒀀𒄿𒅆𒅀𒊑𒀀𒀀𒅆	NEA
𒄑𒈪𒄑𒈪𒈬	SUX
𒊑𒄴𒋾𒋀𒈨𒌍𒉌	NEA
𒀀𒈾𒄊𒈨𒌍𒈗𒊑𒁁𒉌𒅀	MPB
𒅔𒆕𒀀𒄰	SUX
𒇽𒈦𒈦	NEB
𒈗𒍪𒀊𒅟	SUX
𒊹𒊕𒊩𒆳𒍑𒁇𒈨𒌍	OLB
𒊹𒄑𒊕𒁺𒊏	OLB
𒀀𒁺𒈠𒋾𒊹𒅆	NEA
𒁹𒀭𒌓𒆗𒉡𒅀𒋋	OLB
𒌑𒋼𒅕𒊏𒀸𒋗𒉡𒋾	OLB
𒌉𒇥𒋫𒉺𒆤	SUX
𒊹𒊩𒊕𒀸𒊭𒉌𒉌𒈠𒀀𒁉𒇽𒆠𒋩𒊏	OLB
𒀯𒀠𒈜	STB
𒅟𒅈𒊒𒌋𒉌𒌑𒋗𒊒𒌋𒉌	NEA
𒌉𒌉𒈨𒌍𒋙𒉡𒇻𒄥𒌒𒋙𒉡	NEA
𒀸𒌋𒅗𒄷𒌒𒌅𒊭	NEA
𒀀𒄯𒋗𒌓	MPB
𒆠𒄿𒅆𒌓𒋾𒋗	NEB
𒊹𒊩𒊕𒀸𒊹𒌉𒃮	OLB
𒀸𒌋𒅗𒀀𒄭𒅆𒅁𒋳𒁺𒋙𒉡	NEA
𒁍𒁺𒀀𒉿𒇻	STB
𒇷𒉿𒊺𒊏𒈗𒊒	MPB
𒈾𒋫𒊑𒃻𒌋𒌋	STB
𒊹𒀭𒂗𒋧𒈾𒅇𒊹𒀭𒊹𒆚𒌍	NEB
𒀮𒉿𒈝	MPB
𒀭𒉽𒈛𒀭𒈹𒀭𒃽𒂔𒀭𒈾𒈾𒀀𒀭𒃽𒃻𒂍𒊕	LTB
𒀭𒌌𒈦𒋗	SUX
𒆷𒋡𒋾	STB
𒀭𒈨𒌍𒉡𒌑	MPB
𒁹𒀭𒂗𒋺𒆗𒉡	LTB
𒄖𒊌𒋡𒉌𒂊𒌓𒌍𒌍𒈨𒌍𒅇𒊩𒈠𒃮𒁉𒃻𒀀𒈾𒄑𒊒𒁀𒇽𒄊𒋝𒌑𒌓	LTB
𒆷𒄿𒁁	STB
𒊹𒋻𒈨𒌍𒆍𒀭𒊏𒆠	STB
𒃻𒈗𒂗𒐊𒌝𒈠𒆠𒄿	NEB
𒈠𒀀𒌒𒌓	NEA
𒇽𒈨𒌍𒊭𒀸𒁍𒉏𒄿𒈾𒂍𒃲𒅆	MPB
𒁄𒁷𒉡𒆪𒊻𒋢𒌋𒄩𒊏	STB
𒈠𒀀𒄵𒋾𒅆𒊹𒈨𒌍𒋙𒉡𒈠𒁲𒀉	NEA
𒀉𒋾𒈗𒆠𒄿𒉌𒀭𒈨𒌍𒉌	NEB
𒇽𒈨𒌍𒈠𒍝𒅈𒋫𒅇	MPB
𒀀𒈾𒉚𒌀𒈨𒌍𒀀𒈾𒀀𒃻𒀀𒃻𒀀	LTB
𒈨𒌍𒄿𒉺𒅁	NEA
𒊭𒊹𒀭𒃲𒈨𒋛	NEA
𒀸𒉠𒌅𒊕𒈠𒋢𒉡𒋼	STB
𒈬𒈨𒌍𒀉𒋰𒋗𒌑𒁹𒌑𒁇𒀀𒃻𒊹𒀀𒃻𒀀	LTB
𒇽𒈬𒌑𒌓𒄑𒊒𒁀𒈨𒌍𒈬𒈨𒌍𒃻𒀸𒅆𒊹𒀭𒌈𒀭𒈹𒀭𒈾𒈾𒀀	LTB
𒅇𒀀𒈾𒆪𒂟𒈨𒌍	NEB
𒀸𒌋𒅗𒉈𒂊𒈬𒊭𒆳𒈾𒄀𒌋	NEA
𒊭𒀭𒂗𒍪𒅖𒈨𒀀𒀭𒉌	OLB
𒀀𒈾𒆍𒀭𒀉𒋫𒁷	NEB
𒊹𒊹𒀸𒆷𒋛𒈠𒉌𒋙𒅆	STB
𒀭𒂗𒂠𒂷𒆪𒀭𒊩𒌆𒋚	SUX
𒄿𒍮𒌓𒁺	STB
𒀭𒉌𒌑	NEA
𒀭𒉌𒊭𒀭	NEA
𒌉𒈨𒌍𒇽𒆥𒄄𒀀	OLB
𒌅𒀀𒊒𒁲𒂊𒉡𒅗𒅗𒆷𒀾𒋙	NEA
𒌅𒄩𒀭𒅘	STB
𒈬𒈨𒌍𒃻𒀀𒃻𒈾	LTB
𒃮𒊑𒋀𒀕𒆠𒅆𒂠𒊏𒋙𒁶	STB
𒊹𒆠𒀸𒈪𒄿𒉡𒍑𒈾𒍠𒆳𒈾𒁲𒂊𒆳	STB
𒂍𒀲𒆳𒈨𒌍𒇽	NEA
𒁹𒈗𒊑𒁁𒅀𒀭𒅀𒀭𒌓𒅀	MPB
𒌷𒍣𒅁𒁀𒌈𒆠	OLB
𒇽𒄑𒇀𒊭𒇽𒉆𒌷𒈨𒌍	NEA
𒁹𒀀𒁉𒊭𒄀𒅖	OLB
𒀸𒅆𒂗𒈨𒌍𒋙𒀀𒁁𒋢	NEA
𒋫𒈥𒊩𒊹𒄭𒄭𒁹𒆪𒌑𒊑𒃻𒊹𒅆𒈨𒌍𒃻	STB
𒈠𒀀𒀀𒊮𒂵𒈨𒌍𒊭𒉆	NEA
𒊹𒊕𒀴𒀀𒈾𒂍𒅆𒁾	OLB
𒅇𒆷𒀀𒀀𒍝𒋳𒈠𒈬𒄰𒀭𒉌𒋫	MPB
𒉽𒍣𒈠	STB
𒉌𒌓𒈩𒊹𒀊𒁲𒋛𒆪𒉌	NEA
𒁹𒁀𒆠𒅀	OLB
𒊹𒀭𒂗𒁕𒇽𒃻𒌆𒋙𒉡	NEB
𒌉𒈗𒁁𒇷𒌑𒁕	NEA
𒁹𒆪𒌦𒅆𒈠𒌈	OLB
𒆥𒊹𒈦𒈦𒊹𒊹𒈦𒊹𒊹𒊹𒊹𒊹𒊹𒊹𒊹𒊺	STB
𒀹𒁯𒀭	OLB
𒃻𒋗𒈬𒋾𒀭𒁕𒃶	OLB
𒂟𒈨𒌍𒌷𒊺𒄴𒆷𒇷𒆠𒋳𒈠𒌑𒌌𒀸𒉺𒆪	MPB
𒌋𒊺𒉻𒈨𒌍𒀀𒋾𒁷	NEA
𒊹𒀭𒂗𒌋𒀭𒀝𒁀𒆳𒌓𒈨	NEB
𒆍𒀭𒆠	NEA
𒀭𒄊𒌉𒀭𒌓𒆤	SUX
𒃻𒌉𒃻𒈨𒌍𒉺𒃻𒈜𒌈𒃻𒂍𒈬𒈨𒌍𒊹𒌑	LTB
𒋝𒋫𒉏𒂠𒈬𒍪𒃶𒅅	SUX
𒃻𒄘𒃮𒀀𒆠𒀸𒉺𒀭𒈗	NEB
𒊭𒈗𒅖𒁍𒊏𒈾𒅆𒀭𒉌	NEA
𒀭𒈨𒌍𒃲𒈨𒌍𒄿𒈜𒄷𒊒𒈠	STB
𒁹𒁍𒉡𒀭	OLB
𒊮𒁍𒊭𒈗𒁁𒉌𒐊𒇻𒄭𒂵𒋙	NEA
𒆳𒌦𒈾𒀸	STB
𒈠𒀀𒋫𒀀𒇽𒄀𒂇𒀀𒀀𒋫𒅆𒈠𒀀𒆠𒄿𒀭𒉌𒄿	NEA
𒁕𒀀𒈠𒀾𒌈𒃻𒁉𒈩𒋙𒉡𒊹𒑛𒌑𒊕𒆠𒀭𒋫𒅎𒋛𒁲𒁕𒈨𒌍𒉺𒅆𒌈𒃻𒂍𒈬𒈨𒌍𒊹𒑛𒌑	LTB
𒀲𒆳𒊏𒈨𒃻𒈗𒀀𒈾	NEB
𒈬𒄭𒂵	OLB
𒐕𒐕𒐕𒐕𒐕𒐕𒐕𒐕𒁲𒁓𒁓𒁓𒌋𒌋	SUX
𒌑𒂟𒁉𒋫𒀭𒈾𒋙𒅇𒂍𒈨𒌍𒉌	NEB
𒌅𒆸𒁄	STB
𒅇𒀭𒈾𒁉𒌝	OLB
𒀀𒅆𒀀𒇷	MPB
𒃻𒃲𒃲𒆷𒋗𒈪𒉌𒊬𒊬	SUX
𒁹𒄿𒁷𒀭𒂗𒍪	OLB
𒌌𒌅𒀸𒁁𒆠𒆠𒄿𒀀𒁍𒁉𒋙	NEB
𒆷𒆠𒇽𒅈𒉌𒈗𒂟𒈨𒌍𒁹𒀀𒍣𒊑	MPB
𒁕𒀊𒋫𒆷𒋡𒌁𒋫𒋫𒊹𒊐	STB
𒀭𒅆𒁯𒁯𒉌𒃮	SUX
𒊹𒀲𒑏𒆜𒌷𒄣𒌝𒁀𒋼	NEA
𒌑𒋛𒊑𒁀𒀀𒉌	NEA
𒁁𒇷𒅀𒀭𒌓𒆳𒆳𒆠𒀸𒀸𒅇	MPB
𒋀𒅀𒈗𒆳𒈪𒄑𒊑𒅎𒈠	MPB
𒃻𒈾𒆚𒋼	NEA
𒊭𒉈𒈨𒉌𒀸𒅆𒈗	NEA
𒀴𒅟𒊹𒌋𒌋𒅆𒇲𒀭𒉌	NEA
𒄩𒆷𒈨𒌍𒋙𒉡𒌌𒄿𒌉𒊒𒌑𒈠𒆠𒀀𒄩𒀀𒈩𒀀𒈾𒌓𒈬𒍝𒀀𒌓	LTB
𒁾𒁹𒁹𒁹𒆚𒈠𒀭𒀭𒀀𒉡𒌝𒊹𒋗𒊹𒈬𒁉𒅎	SUX
𒃻𒋗𒈾𒁉𒀭𒂗𒍪	OLB
𒊹𒂗𒌓𒈬𒀀𒁲𒉺𒉌𒅀𒋀𒌑𒀀	NEB
𒀉𒋫𒀠𒅟𒅅𒁲𒁉𒀀	NEA
𒀭𒇽𒅲𒋛𒁲𒀭𒀫𒌓	SUX
𒊹𒀭𒀝𒋀𒅕𒀀𒈾𒈗𒅋𒋰𒊏𒌝𒈠	NEB
𒄊𒊹𒂆𒍑𒊕	OLB
𒊹𒈠𒈾𒆬𒌓𒀸𒊹𒈠𒈾𒀀𒀭𒅇𒀸𒊹𒊹𒈠𒈾𒀀𒀭	NEB
𒉽𒊹𒊹𒉺𒇷𒄴𒅟𒈜𒂁	NEA
𒇻𒂊𒁍𒍑𒋫𒌋𒅗𒇽𒊕𒈨𒌍	NEA
𒁹𒀀𒁍𒌝𒉿𒃼	SUX
𒀜𒋫𒁷𒈗𒂗𒀀	NEB
𒀭𒀝𒌋𒀭𒀫𒌓𒅅𒋫𒁍𒌑	NEB
𒌒𒌓𒀀𒈾𒌋𒅗𒄭𒅀	NEA
𒌝𒈠𒊹𒀭𒀝𒌑𒊩𒅆𒁁𒉌𒆪𒉡𒇸𒌨	NEB
𒊹𒀯𒇻𒅂𒀸𒌗𒃶𒅆𒅕	STB
𒀭𒊩𒌆𒈨𒂗𒆤𒆠𒊬𒋥𒉌𒁍𒊒	SUX
𒌷𒈗𒅅𒁉	NEA
𒉌𒌓𒌓𒀸𒊹𒋗𒋛𒊒𒌒𒃻𒃻	NEA
𒁹𒁕𒁺𒌝	OLB
𒀀𒈾𒈬𒌨𒄣𒃻𒄩𒆷𒋙𒉡𒀀𒈾𒌓𒈬𒍝𒀀𒌓𒈾𒋗𒌑𒌋𒌋𒌓𒈬𒃻𒊑𒅅𒋛𒃻𒁕𒊑𒀭𒈾𒀀𒌑𒃻𒀭𒉡𒌑	LTB
𒉿𒉿𒊭𒊏𒂟𒈨𒌍	MPB
𒋙𒉏𒈠	NEB
𒁹𒁲𒀪𒌑𒉺𒀭𒌅𒋢𒈪𒋚𒌈𒆠𒊒𒁀𒀀𒈬𒈨𒌍𒆠𒊒𒁀𒀀𒈬𒈨𒌍𒄿𒍢𒌋𒈠𒀀𒁺	LTB
𒆠𒄿𒃻𒄷𒊺𒂟𒈨𒌍𒆰𒁇𒈬𒆗𒈠𒌓𒈬𒉡	STB
𒌶𒁀𒀯	SUX
𒊹𒂍𒌋𒄑𒂄𒈨𒌍𒈬𒈨𒌍𒀉𒋰𒋗𒌑𒀀𒃻𒌋	LTB
𒊬𒊒𒄀	SUX
𒊮𒁉𒋗𒉡𒆷𒆪𒀲𒆳𒊏𒈨𒌍	MPB
𒂊𒆪𒇻𒊹𒂗	NEA
𒇽𒉽𒈨𒌍𒋼𒊭𒈗𒂗𒅀𒌒𒌓	NEA
𒄿𒉡𒈠𒀀𒆷𒂵𒀝𒆪	MPB
𒉽𒊹𒇽𒆬𒁴𒈨𒌍	LTB
𒄑𒇀𒈨𒌍𒉺𒈾𒉡𒌑𒁀𒌑	MPB
𒀭𒀸𒁽𒌓	SUX
𒊑𒄭𒊹𒈪𒃵𒈪𒇻𒁺𒈠𒇻𒊹𒊹𒃵𒊹𒊹𒊹𒊑𒊕𒆠𒄞	STB
𒈠𒇻𒌑𒈨𒅇𒅁𒋼𒄖𒌑𒈠𒀪𒋫𒋫𒀭𒉌𒅖𒈠	MPB
𒀀𒁲𒂊𒃻𒁷𒌁𒆠	NEB
𒉆𒄩𒅈𒋾𒁹𒀭𒂗𒍪𒁁𒂖𒉌𒉌	OLB
𒁀𒊑𒂵𒁀𒊑𒂵𒁀𒊑𒂵𒑏𒑏𒍥𒍑𒀀𒈾𒆠𒁉𒃻	OLB
𒉡𒄿𒄷𒄭𒌅𒆠𒄿	NEB
𒅗𒃶𒉈𒅔𒄀𒂗	SUX
𒊹𒌋𒈠𒀀𒁺𒈠𒆷𒁀𒋗𒌑𒃮𒁉𒀀𒈾𒊹𒂆𒆬𒌓𒄑𒋫𒌁𒊏𒉡	LTB
𒌉𒌉𒌉𒀀𒁹𒋩𒅆	MPB
𒅀𒀀𒉡𒋗𒄿𒇻𒊭𒄿𒈾𒉺𒉌𒅀𒆷𒀉𒁍𒌑	STB
𒇽𒀀𒋛𒊒𒌑	OLB
𒉆𒄯𒋾𒌉𒆍𒀭𒊏𒆠	OLB
𒀉𒋾𒀭𒊹𒁺𒈨𒌍	STB
𒀭𒂗𒆤𒁕𒉪𒅅	SUX
𒑛𒂆𒆬𒌓	SUX
𒉺𒄑𒉺𒄑𒄒	STB
𒄑𒅅𒃻𒉺𒉌𒉌	NEB
𒀀𒈾𒆳𒋗𒌒𒌈𒉈𒄴𒌈	STB
𒌗𒋞𒀀𒌓𒊹	OLB
𒀀𒋗𒁓𒀀𒀀	NEA
𒀠𒋰𒆜𒋙𒉡𒋾	NEB
𒊭𒄀𒅖𒈝𒁮𒃻𒊭𒀀𒅀𒆠	OLB
𒉺𒂆𒍑	SUX
𒀀𒃻𒌋𒀀𒃻𒀀𒃻𒀀𒈨𒌍	LTB
𒊹𒃻𒃻𒊹	LTB
𒄊𒊹𒉺𒀀𒋛𒊑	OLB
𒀀𒁺𒌑𒀉𒋾𒊹𒀭𒊩𒌆𒃲𒋧𒈾	NEB
𒁹𒆠𒁷𒀭𒈨𒌍𒀀𒁀	STB
𒅅𒁲𒁉𒀀𒈠𒀀𒊹𒈨𒄑𒇀𒈠	NEA
𒃵𒄯𒋫𒁷𒍝𒆗𒆷𒆠	NEA
𒃻𒆷𒁲𒋻𒌋𒆷𒄯𒊏𒊏𒊹𒈠𒈾𒆬𒌓𒉽𒁀𒉡𒌑𒄿𒉆𒁷𒄀𒋡𒉡𒌑𒌋𒄑𒃡𒀀𒈾	LTB
𒀭𒄖𒆷𒁮𒁉𒊩	SUX
𒀭𒌨𒈨𒍣𒅅𒊒𒊩𒈛𒀭𒁁𒀖𒁉𒊑	STB
𒁹𒇻𒉺𒀝𒆪𒂖𒋼𒆪𒉏	MPB
𒊩𒈬𒌑𒊹𒁺𒆰	NEB
𒀀𒈾𒂄𒈪𒅀𒀉𒊑𒅟	NEB
𒊭𒊹𒀭𒅀𒁕𒀪	NEA
𒊹𒂊𒊕𒀭𒊭	NEA
𒇽𒌓𒊑𒍮𒋼	NEA
𒅇𒉺𒂍𒈨𒌍	OLB
𒋗𒁇𒈗	OLB
𒀀𒅀𒁉𒈗𒅖𒌅	MPB
𒇷𒄑𒁁𒈠𒀀𒉌𒉌	NEB
𒂗𒐊𒋫	NEA
𒀉𒋫𒀜𒋃	NEA
𒈠𒀜𒆬𒌓𒅇𒇻𒌓𒋾𒈾𒀝𒆪𒀭𒉡𒌑𒈪𒅎𒈠𒈠𒀜	MPB
𒂍𒆠𒆪𒊮𒄾𒆷𒅟𒉌	SUX
𒂊𒋼𒄵	NEA
𒈗𒁁𒇷𒇺𒀠𒋙𒉡	NEA
𒌉𒋾𒃶	SUX
𒌌𒅁𒈛𒃻𒋃𒅀𒀉𒋫𒅆𒆠𒄿𒄑𒁀𒌅	NEB
𒋢𒍪𒌑𒊒𒋢𒊏𒈠𒉡𒄿𒈜𒊒𒌓𒄿𒊩𒌓𒉺𒈾𒊏𒂅𒉺	STB
𒆠𒄿𒉿𒄿𒁾𒉿	STB
𒌅𒋻𒊩	STB
𒅁𒁄𒅟𒀜𒌈	STB
𒁹𒀭𒆷𒋛𒈬𒌝𒃼𒊏𒀜	OLB
𒀀𒈾𒀲𒆳𒊏	NEA
𒊑𒍝𒀀𒉡𒂗𒉣	NEB
𒆲𒉡𒁄𒈨𒌍𒋙	STB
𒈗𒈥𒌅𒆠	STB
𒉌𒇽𒃲	NEA
𒍣𒌓𒂟𒆳𒀀𒄯𒊑𒄿	STB
𒌑𒉌𒇻𒌑𒅇𒊮𒁀𒋙𒀉𒋾𒈗𒁁𒉌𒋙	NEB
𒋗𒌒𒁍𒌌𒈠𒁕𒀪𒅎	STB
𒇡𒁍𒋾𒌑𒌅𒀀𒊒	NEA
𒃻𒁹𒋛𒇻𒆪𒉽𒁀𒉡𒌑𒌓𒀀𒈾𒉚𒌀𒈨𒌍𒀀𒈾𒌉𒃻	LTB
𒁹𒉌𒉌𒅖𒈨𒀀𒀭𒉌	OLB
𒁹𒀀𒌨𒊓𒀭𒁯𒈗𒀀𒁹𒆠𒈫	LTB
𒄑𒀀𒈠𒊏𒌅	MPB
𒊹𒊹𒀸𒌗𒄞𒌓𒊹𒄰𒅆	STB
𒊭𒅖𒌅𒌷𒍝𒀠𒇻𒉏𒆠	OLB
𒁄𒄩𒋾𒅇𒆠𒈾𒈾𒆷𒀀	MPB
𒈦𒁕𒊑𒅟𒀀𒀀𒉡	STB
𒄊𒉿𒍮𒉡𒌫	OLB
𒇻𒌑𒄿𒁲	NEB
𒌀𒀴𒀭𒂗𒍪𒇽𒀊𒉣𒈾𒆠	OLB
𒌉𒃮𒌉𒉌	OLB
𒋗𒆸𒊹𒈨𒁴𒊹𒈬𒁉𒅎	MPB
𒋗𒁹𒀭𒌉𒀭𒅎𒄯𒊕𒇽𒄬	MPB
𒉡𒆠𒄿	NEB
𒀉𒅎𒋛𒁲𒆠𒋫𒄑𒆪𒀸𒌋𒅗𒊑𒌍𒅆𒆥𒋡𒁉𒌨𒊑𒌈	STB
𒊹𒀭𒈪𒂗𒉣𒀭𒄝𒃻𒈠𒂗𒉣𒅅𒄯𒌋𒅎𒍇𒇻𒁺	STB
𒌋𒌋𒃷𒀀𒊮𒊹	SUX
𒄑𒂊𒆜𒀸	STB
𒌅𒋀𒉺𒅁	STB
𒀸𒊮𒇽𒉽	NEA
𒀭𒅁𒋼𒁉𒀉𒂍𒈛𒀭𒅁𒆤	SUX
𒌅𒄴𒋫𒍣𒅎	STB
𒈗𒆳𒊻𒈾𒌑𒊐𒉺𒀾	STB
𒌉𒋙𒃻𒊹𒀭𒀝𒉽𒅕	NEB
𒂍𒋗𒈫𒈬𒈨𒌍𒄿𒍢𒌋𒈠𒀀𒁺𒈠𒆷𒁀𒋗𒌑𒃮𒁉𒀀𒁲	LTB
𒊺𒋡𒀸𒀸𒀸𒀸𒀸𒀸𒄦	SUX
𒀸𒉿𒄿𒅟𒂖𒇻	NEB
𒌋𒌋𒈠𒈠𒆷𒄿𒁺𒌋	NEB
𒁲𒈬𒅀𒀀𒅆𒊮𒁀𒅟𒇻𒁕𒀊𒅟	NEA
𒂗𒅀𒆜𒊏𒈾𒄭𒀀	MPB
𒁹𒄿𒁷𒀭𒈾𒈾𒀀	OLB
𒁹𒉿𒅋𒉿𒋢𒈬𒈨𒌍𒊹𒌑𒊕𒆠𒀭𒋫	LTB
𒂗𒌓𒊹𒆚𒀸𒀭𒌓𒋙𒀀𒉐	STB
𒊮𒇽𒀀𒋛𒊒𒌝	OLB
𒆜𒊹𒀀𒈾𒆧𒆠	NEB
𒈬𒈨𒌍𒄿𒍢𒌋𒈠𒀀𒁺𒈠𒆷𒁀𒋗𒌑𒃮𒁉𒁹𒊹𒈠𒈾𒊹𒂆𒆬𒌓𒋡𒇻𒌑	LTB
𒊭𒌉𒅕𒍢𒁴𒉺𒋼𒋛𒀭𒌓	OLB
𒌝𒈠𒀀𒇻𒈠𒊬𒀭𒉌𒈗𒂗𒅀𒁹𒄩𒀭𒉌	MPB
𒁹𒋰𒉌𒀹𒁯	OLB
𒄒𒈬𒈾𒅗𒈬𒉈𒅗	SUX
𒅇𒌨𒂠𒈨𒌍𒀭𒉡𒌅	MPB
𒀭𒈹𒆧𒆠	SUX
𒈗𒇽𒁾𒊬𒆏𒍪𒍪𒊭𒀴𒀭𒀝𒅇𒀭𒊺𒉀	MPB
𒀝𒋡𒁍𒌑𒃻𒄭𒀀𒀉𒋙𒀀𒆳𒈗𒀀𒈾𒌋𒅗𒄭	NEB
𒀀𒈾𒁍𒋢𒉡	STB
𒈾𒈬𒆕	SUX
𒊭𒀭𒅎𒊬𒀸𒉺𒋼𒋛𒀭𒌓	OLB
𒀀𒉌𒇷	SUX
𒄵𒈨𒌍𒉡𒀠𒌀𒃮𒊑𒁷𒌁𒆠𒁶𒌀𒋙𒊬𒈠𒅆	STB
𒂄𒈠𒆠𒁉	MPB
𒄑𒃻𒉺𒄿𒊬𒌅𒄑𒄖𒍝	NEB
𒌋𒀀𒃻𒀀𒈨𒌍	LTB
𒊓𒄠𒌈𒁹𒀹𒁯𒈬𒁀𒉌𒁕𒀜	OLB
𒇽𒀀𒁀𒆳𒀀𒊓𒀪𒀠	NEA
𒁹𒀀𒋫𒈾𒄴𒉌𒉌	OLB
𒁹𒉿𒅖𒅀𒊑𒋡𒁺𒆏𒁉𒌉𒈨𒌍𒋗	MPB
𒇻𒌑𒂄𒈬𒀀𒈾𒈗𒁁𒉌𒄿𒉌	NEB
𒄑𒊒𒁀𒈬𒈨𒌍𒌑𒈥𒊩𒈠𒀪𒀀𒁲𒊹𒀀𒈾	LTB
𒄿𒈾𒄩𒄷𒄭𒅖𒁹𒄩𒀀𒄿	MPB
𒀸𒌓𒊹𒃻𒆠𒋀𒈨𒌍𒋙𒌋𒂗𒈨𒌍	LTB
𒉽𒊹𒇽𒋋𒈨𒌍	LTB
𒃻𒌷𒄭𒌦𒈨𒌍𒋙𒅖𒊕𒄀𒋙𒌷	NEB
𒊭𒅖𒌅𒆍𒀭𒊏𒆠𒅋𒇷𒆪𒉏𒈠	OLB
𒅇𒀭𒄊𒊭𒈗𒅋𒋫𒋻𒋗	MPB
𒅟𒀀𒀀	NEA
𒅇𒇽𒈨𒌍𒆳𒈨𒇻𒄩𒀉𒋾𒋗𒉡	MPB
𒉡𒊏𒈠	NEA
𒀀𒁲𒌷𒃻𒌑𒆥𒈬𒋫𒀀𒀀𒂗𒉣𒈨𒌍	NEA
𒌗𒉈𒉈𒃻𒌓𒊹	OLB
𒌋𒁁𒉌𒄿𒁲	NEB
𒌌𒀀𒄯	NEB
𒀀𒈾𒄊𒈨𒌍𒂗𒅀𒀭𒌓𒅀	MPB
𒈬𒈨𒌍𒅎𒄯𒊒	LTB
𒀭𒀫𒌓𒋾𒆷𒋢𒄰	STB
𒁹𒀭𒈹𒈬𒆚	LTB
𒇽𒊓𒌒𒋼𒉡𒅁𒊒𒊻𒋢𒌋𒃻𒋃	NEB
𒀀𒈾𒌋𒅗𒄭𒄑𒊒𒁀𒈬𒈨𒌍𒀉𒋰𒋗𒌑	LTB
𒌋𒇽𒆬𒁴𒌑𒌓𒃻𒀸𒇻𒀴𒈨𒌍𒃻𒄭𒀉𒉿𒈨𒌍𒃻𒀸𒌓𒈬𒇻𒁍𒃻𒀜𒈨𒌍	LTB
𒌑𒈥𒊩𒈠𒀀𒁲𒊹𒀀𒈾𒊹	LTB
𒊹𒊹𒉡𒅆	STB
𒊹𒈤𒊏𒀜𒂊𒋛𒀀𒀜𒌓𒈬𒉺𒋡𒊑𒀀𒈾𒌋𒅗𒄭𒆠𒊒𒁀𒀀𒈬𒈨𒌍𒀉𒋰𒋗𒌑	LTB
𒊹𒀭𒀸𒁁𒀸𒌗𒋞𒅆𒅕𒊒𒁴𒇽𒉽	STB
𒁹𒄩𒊩𒌆𒀭𒂊𒋛𒀪	LTB
𒀀𒅟𒀸𒈾𒈠𒀸	STB
𒇻𒌑𒆗𒈾𒀜	NEB
𒀸𒃻𒁄𒇽𒆳𒋙𒇷𒊺𒅆𒅁𒋙𒅟𒈨𒅖	STB
𒀀𒃻𒀀𒃻𒇽𒋛𒌓𒈨𒌍𒃻𒂵𒊹	LTB
𒁹𒁀𒃻𒀀	LTB
𒀀𒁹𒀭𒂗𒆪𒀫𒋙𒊹𒄥	LTB
𒊏𒃻𒀀𒋫𒈲	NEB
𒋾𒌍𒁇	NEB
𒁹𒅁𒉌𒀭𒈥𒌅	OLB
𒁹𒄿𒈾𒉺𒇷𒋗	OLB
𒀀𒈾𒉡𒉽𒋾𒈨𒌍𒈗𒁁𒅀𒃻𒉌𒌓	MPB
𒁲𒅗𒁀𒅅𒆷𒀀𒀭	SUX
𒃮𒁉𒃻𒌗𒊻𒋢𒆗𒈬𒀭𒈾𒄖𒊌𒋡𒉌𒂊𒌓𒀊𒀊𒈨𒌍𒌋𒊩𒈠𒃮𒁉	LTB
𒇽𒈾𒁷𒈾𒉡𒇽𒌓𒁴𒈬𒈨𒌍	LTB
𒊭𒄿𒈾𒂍𒀭𒀫𒌓𒈾𒍢𒅕𒉺𒈥𒌅	OLB
𒌑𒊕𒆠𒆠𒋫𒅎𒆳𒊏	LTB
𒄠𒈠𒊒𒌋𒀀𒋆𒈬𒌋	NEB
𒌑𒋼𒅕𒊏𒋗𒉡𒋾	OLB
𒇽𒉺𒇻𒀖𒄞𒄭𒀀𒃻𒈗	NEB
𒈪𒅎𒈠𒊓𒁉𒄣	MPB
𒊭𒀸𒁲𒁀𒄷𒉺𒋼𒋛	OLB
𒇽𒂈𒄿𒉺𒅁𒊏	NEA
𒌓𒈬𒈠𒆷𒊩𒁹𒃲𒋙𒍢𒁀𒀜𒄑𒊒𒁀𒈬𒈨𒌍𒀸𒄑𒁕	LTB
𒊹𒀯𒀠𒈜𒀸𒊮𒉣𒇬𒊹𒁺	STB
𒌨𒀭𒉌	SUX
𒀸𒆪𒊑𒇷𒋙𒉡𒌷𒄵𒋾	NEB
𒈗𒌑𒋾𒅖𒅆𒄿𒈾𒈤𒊑𒄿	NEB
𒀀𒃻𒀀𒃻𒀀𒀀𒈾𒌓𒈬𒍝𒀀𒌓𒋗𒌑𒀀𒈾𒅎𒈭𒋀𒌈	LTB
𒋀𒈨𒌍𒋙𒌉𒈨𒌍𒊹𒌉𒃻𒊹𒀀𒈨𒌍𒀀𒁹𒂠𒍪𒌑	LTB
𒃻𒋃𒈨𒌍𒋙𒉡	NEB
𒌉𒁲𒁲𒌉𒊐𒁍𒌉𒌉𒍢𒄴𒊑	STB
𒂦𒅗𒈬	SUX
𒅎𒃻𒈗𒆷𒄿𒁄𒆷𒄷	NEB
𒇷𒊒𒌒𒈠𒀀𒈨𒌍𒇻𒈠	NEA
𒂊𒋾𒄣𒌋𒉌	NEA
𒆳𒅕𒊒𒌨𒈠	STB
𒀀𒈾𒁲𒈾𒀭𒈗𒁁𒉌𒅀𒈜𒌨	NEB
𒈠𒆷𒁀𒋗𒌑	LTB
𒆷𒄿𒉺𒅁𒌓𒋗𒌑𒌉𒊩𒋢𒃻𒊹𒁷𒌁𒆠𒀀𒀀	NEB
𒄿𒈾𒆠𒋩𒊏𒆠	OLB
𒌷𒋼𒀀	NEB
𒌋𒌋𒌋𒈠𒈾	SUX
𒌓𒊹𒄰𒅂𒀊𒊺𒄀𒁕	STB
𒊹𒀸𒂗𒉣𒅟𒊹𒁹	STB
𒊹𒇽𒈾𒁷𒈾𒄑𒊒𒁀𒈬𒈨𒌍𒌑𒈥𒊩𒈠𒂗	LTB
𒆠𒋫𒅎𒍇𒇻𒁕	LTB
𒋠𒌋𒈠𒈾𒋫	SUX
𒊹𒄑𒊩𒌓𒂔𒍝𒉡𒌝	SUX
𒆠𒈫𒆷𒄿𒁲	STB
𒀀𒈾𒈗𒊑𒂗𒅀𒅇𒀭𒌓𒅀	MPB
𒊹𒆪𒈾𒀀𒌉𒋙𒃻	NEB
𒌉𒊩𒃻𒀸𒄷𒌓𒊮𒁉𒋙𒊹𒇽𒀴𒋢	LTB
𒁁𒈠𒈠𒁲	NEA
𒀀𒇉𒆠𒉘𒂷𒉌	SUX
𒌝𒈠𒁹𒁀𒉿𒁲𒀴𒅟	MPB
𒃼𒄩𒀀𒋼𒀭𒈾𒅟	NEA
𒌗𒄑𒀳𒃮𒀀𒅟	SUX
𒊹𒋡𒊺𒅔𒉡𒀸𒋡𒉌	NEA
𒊭𒊏𒋗	MPB
𒁳𒁉𒆷𒀾𒋙𒋼𒋙𒉡	NEA
𒂊𒌀𒅗𒀹𒁯	OLB
𒀭𒀴𒊏𒈫	SUX
𒃮𒋾𒅔𒉡𒌑𒀸	STB
𒃻𒁉𒈩𒋙𒉡𒃻𒀸𒆠𒁴𒊬𒈤𒃻𒆠𒆗𒀕𒆠𒀸𒌗𒋞𒈬𒊹	LTB
𒀴𒀭𒀝𒅇𒀭𒊺𒉀	MPB
𒈠𒀪𒁹𒆗𒈾𒀜𒊮𒁀𒃻𒈗	NEB
𒌷𒃻𒊏𒄀𒋾𒀸	NEB
𒁹𒇷𒂡	LTB
𒉌𒅅𒄭𒊑𒁉	NEA
𒀀𒈾𒊹𒋧𒈾𒋀𒀜𒋙	NEB
𒊭𒈗𒂗𒅖𒁓𒀭𒉌𒈠𒀀	NEA
𒁺𒌦𒆠𒅀𒅇𒀀𒈾	NEB
𒃶𒈾𒀝	SUX
𒈗𒁁𒉌𒇺𒃻𒀠𒅇𒁾𒉿𒇺𒋗𒉏𒈠𒀸𒉺𒀭𒈗𒇸𒋢𒌑	NEB
𒇺𒁍𒊏𒊩𒈠	NEB
𒀸𒌋𒅗𒉈𒈨𒊭𒇽𒂟𒈨𒌍	NEA
𒄿𒉡𒈠𒇽𒉺𒁼𒅀	MPB
𒀀𒈾𒌓𒈬𒍝𒀀𒌓𒈾𒋗𒌑𒊹𒃻𒌓𒈬𒀸𒊹𒌓𒈬	LTB
𒁹𒀀𒂵𒀠𒀀𒈾𒀭𒀫𒌓	OLB
𒉿𒅅𒋫𒋼	NEA
𒊭𒊹𒀉𒂊𒁉𒄑𒋛	NEA
𒊭𒀀𒊑𒍜𒅟𒁉𒅟	MPB
𒊹𒃻𒌓𒈬𒀸𒊹𒌓𒈬𒀸𒌓𒊹𒌓𒊹𒄑𒊒𒁀𒋙𒉡𒇽𒆭𒂍𒌑𒌓	LTB
𒊏𒁉𒍣𒅟𒌈𒌒𒇴	OLB
𒇽𒊓𒄤𒈨𒌍𒅇𒈪𒋫𒋾	MPB
𒀀𒈾𒊹𒂆𒆬𒌓𒋡𒇻𒌑𒄑𒋫𒌁𒊏𒉡𒈨𒌍𒁹𒋛𒇻𒆪	LTB
𒂍𒂍𒊩𒂊	SUX
𒆷𒉺𒀭𒊹𒈾𒁲𒉡	NEB
𒄿𒀫𒄑𒍮𒌨	MPB
𒀭𒊕𒈨𒃻𒂗𒀭𒈨𒌍𒈤𒂊𒊐𒀭𒂗	STB
𒅔𒈾𒁁𒌅𒈠𒆷𒀀𒀜𒊒𒌓𒈪	MPB
𒊏𒁀𒌑𒌌𒆷𒆠𒁹𒀴𒀀𒅆𒅕𒋫	MPB
𒊭𒌑𒊺𒁉𒇻𒀀𒈾𒉺𒉌𒆏𒁉𒋗𒉡𒈠𒀀𒉌𒈾𒄑𒊩𒌅	MPB
𒌋𒀸𒀸𒄘𒌦𒆬𒌓𒊹	SUX
𒄿𒈾𒌗𒉈𒉈𒃻𒌓𒊹	OLB
𒉺𒇷𒄴𒈗𒈜𒆤𒋢	NEB
𒀭𒄑𒊹𒁳𒁳𒋗	SUX
𒈗𒀭𒉌	SUX
𒊹𒅖𒊒𒁀𒀭𒉡𒉌𒌈𒌝𒈪	OLB
𒁹𒄿𒁷𒀭𒅎	OLB
𒀸𒌋𒅗𒌉𒈨𒊑𒊭𒋫𒂗𒆤𒆠	NEA
𒍪𒁲𒂊𒇽𒆥𒄄𒀀𒈨𒌍	OLB
𒃻𒀉𒋾𒌉𒃻𒌉𒃻𒌉𒃻	LTB
𒊩𒋗𒉈𒌈	LTB
𒂆𒃸𒅎𒈪𒋧	SUX
𒀀𒈾𒁷𒌁𒆠𒌌𒄿𒊒𒌒𒌌𒌑𒍝𒀀	NEB
𒌀𒈨𒌍𒆠𒈫𒊩𒉽𒈨𒌍𒀸𒆳𒅅𒈨𒌍	STB
𒇽𒂗𒄭𒂵𒋾𒉌𒀀𒈾𒀊𒉿𒌑𒋛𒍢𒌋	NEA
𒄑𒍣𒍝	MPB
𒃻𒉿𒄿𒇽𒌝𒌋𒌋𒉡𒁇𒈨𒆠	STB
𒂊𒋫𒄠𒅆𒀀𒀭	OLB
𒃻𒉌𒌓𒁹𒀴𒀸𒊏𒋾𒇽𒌨𒆪	MPB
𒊭𒌀𒆷𒅀𒀀𒈾𒄊𒈨𒌍𒂗𒅀	MPB
𒆷𒀝𒊒𒌋𒉌	NEA
𒉌𒉌𒅀𒌈	OLB
𒋗𒌓𒊹𒌷𒀭𒉌𒋫𒅇	MPB
𒀀𒁁𒈗𒄿𒍠𒋼𒀀	NEA
𒇽𒈬𒁺	LTB
𒋫𒅆𒊹	NEA
𒅆𒊹𒊹	STB
𒌉𒀀𒈾𒉺𒉌𒀭	OLB
𒊮𒊭𒆷𒀜𒉌𒋛𒅔𒆠	OLB
𒊹𒊹𒌑𒊕𒆠𒈪𒋚𒌈𒆠𒊒𒁀𒀀𒈬𒈨𒌍𒆠𒊒𒁀𒀀𒈬𒈨𒌍𒄿𒍢	LTB
𒀀𒈾𒂟𒊮𒄞𒈨𒌍	OLB
𒀭𒇴𒅆𒁺	SUX
𒅇𒋗𒃻𒌉𒇲𒁉𒉌𒉌𒌅𒊏𒄠	SUX
𒌑𒊏𒁕𒀀𒈠𒋫𒄩	NEA
𒊹𒊕𒊩𒆳𒊩𒍑𒁇𒈨𒌍	OLB
𒃻𒀭𒂊𒌋𒆠𒁴𒁀𒆳𒌓𒈨𒌍𒁍𒁕𒈨𒌍	NEB
𒌌𒀀𒊏𒀾𒅆𒄿𒈾	NEB
𒂍𒅎𒋛𒁲𒌍𒋙𒌋𒂍𒅎𒆳𒊏𒆷𒍮𒇻𒇻𒌌𒄩𒆷𒃻𒁹𒀭𒈾𒈾𒀀𒈬𒇽𒋀𒉠𒌑	LTB
𒀸𒉺𒉌𒅟𒀀𒀀	NEB
𒋗𒃮𒀀	OLB
𒀭𒈾𒅟	NEA
𒇽𒈨𒌍𒃻𒁹𒌋𒅗𒆪𒌋𒊑	STB
𒀉𒁷𒌋𒆠𒄿𒀉𒆗𒉡𒌌𒁺𒍪𒌋𒌑𒊩𒇴𒄿𒉆𒁷𒃻𒆷𒁲𒋻	LTB
𒍣𒂵𒊮𒂍𒊩𒍑𒁇	OLB
𒀀𒁲𒀀𒋫𒈥𒍜𒊹𒅆𒈨𒌍	MPB
𒈗𒆬𒅟	SUX
𒊹𒊕𒊩𒆳𒈨𒌍𒀀𒈾𒊮𒄞	OLB
𒊹𒀯𒇻𒅂𒁹𒌋𒅗𒊹𒋜𒈠𒁺	STB
𒀠𒇻𒈪𒆷𒆠𒌷𒁺𒆷𒆠	MPB
𒌅𒃻𒀭𒃻	STB
𒄿𒉆𒁷𒁍𒌑𒌓𒀀𒄩𒀀𒈩𒀀𒈾𒈬𒌨𒄣𒃻𒂍𒈬𒈨𒌍𒊹𒇽𒈾𒁷𒈾	LTB
𒀴𒀭𒊏𒄠𒈠𒉡𒌝	OLB
𒁁𒊏𒆬𒄀	MPB
𒇻𒍑𒇻𒊩	STB
𒈗𒂗𒂗𒂗𒅀𒀀𒈾𒆳𒋗	MPB
𒀀𒈾𒁹𒀭𒈾𒈾𒀀𒈬𒋀𒋙𒀀𒃻𒊹𒀀𒈾𒌓𒈬𒍝𒀀𒌓	LTB
𒀀𒈨𒌍𒃻𒂵𒁉𒅔𒂕𒊹	LTB
𒊭𒅁𒉌𒀭𒈥𒌅	OLB
𒅈𒁕𒃲𒋫𒄷𒄭	STB
𒆠𒀀𒅘𒂊𒄩𒁀𒁺	SUX
𒊹𒊹𒀸𒆷𒈪𒈾𒋾𒋙𒅆	STB
𒊌𒁕𒊑𒁀	NEA
𒆠𒄿𒅋𒇷𒆪𒉡𒄿𒃻𒀀𒇻𒋙	NEB
𒈜𒅆𒀉	STB
𒀭𒉣𒌴𒊏𒈫	SUX
𒀭𒈨𒌍𒅀𒀭𒌓𒅀𒊭𒊑𒌀𒆷𒅀	MPB
𒄭𒀉𒆷𒁍𒈾𒄴𒆗𒌓	STB
𒌑𒋫𒄴𒄭𒄑	NEA
𒁹𒀹𒁯𒋾𒆷𒋾	OLB
𒅇𒄑𒍝𒊍𒍪𒌋𒅗𒌷𒀸𒀸𒄭𒀀	MPB
𒂍𒈬𒈨𒌍𒁕	LTB
𒀀𒃻𒀀𒃻𒀀𒀀𒃻𒀀𒃻	LTB
𒀭𒅗𒌤𒀀	SUX
𒁹𒀭𒌓𒀭	OLB
𒀸𒆳𒁇𒊭𒇽𒂗𒉆𒈨𒃮𒁉𒋙𒉡	NEA
𒀭𒂊𒊩𒌆𒌷𒁇𒊏𒋗	SUX
𒀀𒈾𒌀𒆷𒋾𒅇𒌑𒌌𒌅𒀀𒉿𒌅𒅀𒍑𒈬𒈾	MPB
𒉺𒉡𒌑𒆠𒄿𒌑𒋼𒊏𒀾𒋙	NEB
𒉡𒅅𒅆	STB
𒊹𒊮𒀜𒇷𒁍𒇻𒍝𒌉𒊩𒉌	OLB
𒊭𒆠𒁉𒋳𒈠𒋾𒆗𒉺𒊩𒆳𒈨𒌍	OLB
𒀀𒇉𒉋	SUX
𒀸𒌋𒅗𒌉	NEA
𒁹𒀭𒌓𒉡𒊑	OLB
𒀭𒈾𒈾𒀀𒀭𒃽𒃻𒂍𒊕𒀭𒊬𒊏𒄭𒄿𒌈𒌋𒀭𒈨𒌍𒂍𒈨𒌍𒋙𒉡𒃮𒁉𒄩𒀭𒍝𒌋𒈪𒋻	LTB
𒅀𒀝𒁍𒈗𒊒𒂗𒇷𒀀𒈾	MPB
𒉆𒌀𒈨𒌍𒀸𒆳𒅅𒈨𒌍	STB
𒇽𒆷𒁀𒉌𒇲𒂊	SUX
𒅇𒅀𒉡𒊭𒉿𒅅𒁉𒈪𒄠𒈠	MPB
𒁹𒈬𒊏𒋗𒌑𒀀𒃻	LTB
𒅇𒋼𒅎𒄩	MPB
𒀀𒈾𒄊𒈨𒌍𒁁𒇷𒅀𒄠𒋻	MPB
𒁹𒈠𒀭𒋧	SUX
𒄿𒊑𒁍𒈪𒊹𒇽𒈨𒌍𒅖𒌅𒊮𒁉	MPB
𒃷𒃷𒀀𒊮𒊹	SUX
𒅎𒍇𒇻𒁕𒂍𒅎𒋛𒁲𒂍𒈬𒈨𒌍𒊹𒑛𒌑𒊕𒆠𒀭𒋫𒅎𒈥𒌅𒁕𒂍𒅎𒆳𒊏	LTB
𒀭𒊩𒈨	SUX
𒂗𒋙𒆷𒌨𒁓	NEA
𒊹𒁀𒆷𒋢𒇽𒃻𒋙𒉡	NEA
𒅆𒄭𒄊𒀀𒉌𒆳𒁕𒉡𒅍	SUX
𒊭𒀸𒁍𒄿𒈾𒂍𒃲𒅆𒅇𒀀𒉡𒌝𒈠	MPB
𒌉𒀀𒁕𒋭𒄴𒈨𒆤	SUX
𒐕𒌋𒄦𒊺	SUX
𒀠𒌀𒅆𒃸	MPB
𒄿𒈾𒉺𒉌𒅟𒅇	MPB
𒈠𒆟𒂊𒋩𒌉𒃻𒀀𒃻	LTB
𒃻𒌑𒀸	SUX
𒉆𒄯𒋾𒉌𒉌𒄿𒁷𒉆	OLB
𒀸𒅆𒅆𒉺𒊑𒄑𒍝𒊍𒍪𒈠𒆷𒊩𒈠𒋼𒄿𒌓𒈬𒌋	STB
𒐞𒊕𒃻𒁺𒐞𒁲𒊹𒊹𒊹𒁓𒁓𒃷	SUX
𒅎𒆳𒊏𒄑𒊬𒂍𒄭𒅋𒀭𒈾𒋗𒆸𒆸𒍑𒈨𒌍𒌋𒊕𒆠𒈨𒌍	LTB
𒉆𒄩𒅈𒋾𒁹𒌋𒁇𒀭𒌓𒋃𒀭𒌓	OLB
𒀊𒀊𒈨𒌍𒌋𒊩𒈠𒃮𒁉𒃻𒀀𒈾𒅆𒅖𒋙𒃻𒌓𒈬	LTB
𒇽𒈨𒌍𒊓𒄤𒋗𒉡𒋾	MPB
𒌋𒀭𒄖𒆷𒊩𒌆𒋾𒋙𒀭𒋾𒌉𒊩𒀀𒉌𒋻𒀀𒂊	MPB
𒌋𒆍𒀭𒊏𒆠𒂟𒈨𒌍	NEB
𒁹𒅁𒉌𒀭𒅎	OLB
𒇽𒃲𒂍𒃻	NEB
𒅇𒄿𒁲𒅈𒈾𒋗𒅇𒄴𒇷𒅅	MPB
𒌉𒃻𒀀𒀀𒈾𒌉𒃻	LTB
𒌋𒂅𒌒𒅆𒄿𒊑	NEB
𒁹𒀭𒈾𒈾𒀀𒊭𒄠𒄩𒀜	OLB
𒋼𒀀𒈬𒊹𒈨𒊹𒌷𒈨𒌍	NEA
𒇽𒀭𒇋𒌉𒋀𒆗𒆷𒆤𒉆𒀵𒂠𒅗𒅔𒉌𒂷𒅈	SUX
𒉆𒌉𒍑𒉌𒂠𒅔𒃻	SUX
𒂊𒋼𒂖𒅗𒀭𒄊𒊏	OLB
𒊹𒌗𒈨𒌍𒀀𒂵𒀀	NEB
𒁹𒌋𒅗𒄭	LTB
𒌉𒁹𒀭𒊩𒌆𒅁𒌑𒋾𒆷𒋢𒁾𒊬𒈗	STB
𒀭𒈗𒀭𒍝𒃼	SUX
𒈾𒆕𒀀𒈗𒆦𒋛	SUX
𒈬𒆚𒁹𒋛𒇻𒆪𒈗	LTB
𒊹𒊕𒊩𒆳𒀴𒈨𒌍𒀀𒈾𒊩𒍑𒁇𒈨𒌍	OLB
𒁹𒀴𒀸𒊏𒋾𒅇𒀀𒈾𒍝𒅈𒈪	MPB
𒈗𒈲𒋫𒇷𒋙	STB
𒂍𒅇𒌑𒉡𒌑𒌓𒂍𒈬𒈨𒌍	LTB
𒀀𒈾𒈗𒂗𒉌𒅀	MPB
𒀴𒅟𒊹𒀭𒀝𒈬𒅖𒆲	NEA
𒊭𒈗𒁁𒉌𒅖𒁍𒊏𒀭𒉌	NEA
𒊹𒌉𒊩𒃮𒈦𒋰𒁀	OLB
𒌅𒈥𒊏𒌒	STB
𒊹𒀭𒀫𒌓𒋧𒈾	NEA
𒂟𒈨𒌍𒁉𒋫𒋾𒅇𒀭𒆠𒉡𒅆𒋛𒈪	MPB
𒀀𒈾𒌓𒈬𒍝𒀀𒌓	LTB
𒌗𒌓𒊹𒆚	NEA
𒊭𒀭𒊩𒌆𒋚𒆪𒋫𒋗𒉺𒊩𒆳	OLB
𒁹𒀀𒁍𒌝𒀭	OLB
𒀀𒁲𒀀𒊬	MPB
𒀸𒄷𒌓𒊮𒁉𒋙𒆠𒊒𒁀𒀀𒂍𒆠𒁴𒂍𒀭𒅎𒃻𒆠𒆗𒀕𒆠𒊹𒌑𒍑𒀭𒌑	LTB
𒁹𒌋𒁇𒀭𒅎	OLB
𒃻𒋗𒊹	OLB
𒅇𒊓𒆏𒇽𒉽𒃻𒈗𒂗𒐊	NEB
𒊩𒆳𒀭𒌓𒈬𒉌𒅎	SUX
𒊭𒌉𒈗𒂗𒅀	NEA
𒌓𒈬𒋗𒋫𒉡𒄷𒈬𒅆𒄫𒊏𒉌	STB
𒀀𒈾𒊹𒌨𒋫𒆪𒈗𒆳𒉏𒆠𒋀𒅀	NEA
𒄯𒊕𒊬𒂵𒅆𒂍𒂊𒁺𒁀	SUX
𒀸𒌷𒋻𒄀𒁀𒀀𒋾𒀸𒌷𒁀𒈾𒈾𒀸𒂍𒊹𒋗𒆷𒀀	NEB
𒀠𒋰𒊩𒅟𒄩𒀭𒁹	NEB
𒊭𒀸𒅆𒈗𒁁𒅀	NEA
𒋙𒊹𒂗𒇽	NEB
𒀜𒋫𒂗𒃲𒌑𒌌	MPB
𒊮𒂍𒀀𒋛𒀸	OLB
𒀀𒌉𒃻𒌉𒃻	LTB
𒁁𒀠𒅖𒋫𒃶𒌑𒃻𒇴𒄿𒉆𒁷𒀀𒈾𒊹	LTB
𒊹𒊹𒌓𒅆𒌨𒊹𒊹𒊹	STB
𒆠𒊒𒁀𒀀𒈬𒈨𒌍𒈪𒋻𒀸𒆠𒊒𒁀𒀀𒈬𒈨𒌍𒄿𒍢	LTB
𒀀𒌉𒃻	LTB
𒅀𒀊𒋫𒈛	NEA
𒊹𒌓𒈬𒀀𒋛𒀀𒈠𒅎𒋛𒁲	STB
𒑏𒑏𒑏𒀭𒋗𒌷𒉌𒋗	OLB
𒇽𒋾𒅀	NEB
𒌗𒆥𒌓𒊹𒈬𒊹𒌋𒁹𒀭𒋾𒀪𒄿𒆪𒋢𒈗𒈨𒌍	LTB
𒊹𒊩𒌉𒀭𒅟𒉌𒋩𒊏𒆷𒈠𒋜	OLB
𒃻𒁹𒀭𒋾𒀪𒄿𒆪𒋢𒉽𒁀𒉡𒌓𒀀𒈾𒉚𒌀𒈨𒌍𒀀𒈾	LTB
𒉿𒅈𒆪	MPB
𒈾𒄠𒄩𒅈𒋾	OLB
𒌅𒀊𒁁	STB
𒃻𒉌𒅖𒊑𒅅𒈬𒃻𒀭	STB
𒍑𒌤𒁉𒈬𒀝	SUX
𒂟𒈨𒌍𒁉𒅕𒁴	OLB
𒌉𒀉𒋾𒀜𒋙𒆤𒌓𒄿𒋫𒈪	STB
𒆳𒉏𒈠𒆠𒇽𒀀𒆥𒅀𒊭𒀸𒆳𒉏𒈠𒆠	NEA
𒁳𒁉𒆠𒄿	NEB
𒀭𒊩𒌆𒊭𒌷𒁺𒆷	MPB
𒊹𒇽𒋃𒌉𒃻𒊹𒀀𒁹𒂍𒆳𒍝𒄫𒀕𒆠𒌗𒋗	LTB
𒀸𒅆𒈗𒌨𒁉	NEA
𒉆𒄩𒅈𒋾𒀭𒈥𒌅𒈬𒊭𒅆	OLB
𒀀𒉿𒋼𒀴𒆠𒋾𒋗	MPB
𒉺𒈾𒉡𒌝	MPB
𒌅𒃻𒂗𒆤𒆠𒃻	NEB
𒍑𒀀𒁺𒀭𒂗𒍪𒀀𒊭𒊑𒀉	SUX
𒊹𒇽𒀀𒋛𒀸𒊮𒊹𒇽𒀀𒋛𒀸	OLB
𒁹𒀭𒅎𒅤𒊭𒀜𒋗	OLB
𒂗𒋫𒄷𒈨𒆪𒉡𒈬𒊌	NEA
𒁀𒋾𒊭𒌓	NEA
𒂄𒈬𒀀𒈾𒈠𒀀𒋼𒊭𒈗𒂗𒅀	NEA
𒀭𒉺𒅇𒀭𒈩𒀀𒈾𒉽𒐊	NEA
𒌷𒉌𒉡𒌋𒍝𒂍	NEA
𒆷𒂍𒄑𒄘𒍝𒌋𒆷𒂍𒄑𒇀𒃻𒌋𒊩𒀀𒆳𒀭𒋗	LTB
𒋗𒁹𒅖𒈠𒀪𒀭𒆳	MPB
𒌦𒋡𒁹𒁕𒆷𒀜𒋫𒀪	LTB
𒈬𒊌𒊹𒀭𒂗𒅆𒇲𒀭𒉌	NEA
𒌗𒉈𒌓𒊹𒄰𒁉𒊕𒁄𒆠	STB
𒅇𒀀𒉡𒌝𒈠𒄿𒅋𒆷𒂵𒄠	MPB
𒀸𒌋𒅗𒊭𒌋𒌋𒁁𒉌	NEA
𒂍𒋢𒌈𒋙𒆠𒁴𒆍𒃲𒀭𒈹𒃻𒆠𒆗𒀕𒆠𒍑𒀭𒌑𒅎𒋛𒁲	LTB
𒈪𒉭𒀭𒋾𒆷𒀸𒆳𒅅𒈨𒌍𒀭𒈨𒌍𒃲𒈨𒌍	STB
𒅇𒀭𒋗𒈾𒉿𒅕	OLB
𒀉𒁕𒉡𒌋𒉌	NEA
𒉺𒊩𒍑𒁇	OLB
𒃻𒆬𒄀𒀀𒄭𒂅𒈠𒀀𒈾𒊹𒌑𒃻𒀭𒉡	NEB
𒀭𒇸𒌉𒀭𒈤𒆤	SUX
𒈦𒌑𒊹𒋗𒋛𒊹	SUX
𒀀𒈾𒈪𒁖	OLB
𒁹𒀀𒁉𒄿𒆷𒄿	MPB
𒄿𒁕𒉡𒌋𒌋	NEA
𒀭𒉌𒉌	OLB
𒀀𒅁𒌅𒌑	NEB
𒀸𒌓𒊹𒌓𒊹𒌓𒊹𒌓𒊹𒅇𒌓𒊹𒉽	LTB
𒉡𒌉𒀭𒂗𒆤𒇲𒆤	SUX
𒁹𒀭𒋫𒁍𒁀𒌝𒈪	OLB
𒈾𒅈𒈠𒀝𒌅𒌓𒅗𒁇	MPB
𒃮𒁉𒃻𒇽𒊑𒁺𒃻𒋫𒁷𒀀𒈾𒊍𒊑𒌋𒀀𒈾𒁕𒅟	LTB
𒂊𒅟𒉡𒇷𒅅𒁉𒊒𒅔𒉌	NEB
𒊭𒀊𒊒	MPB
𒁕𒋛𒍝𒆳	SUX
𒈬𒁉𒂠𒈗𒂍𒈤𒂊𒉆𒉈𒊒𒁉𒌦𒋻𒀵𒁀𒀭𒁺𒈬	SUX
𒊹𒀭𒀝𒅅𒁉𒀭𒀝𒌋𒀭𒀫𒌓	NEB
𒅎𒁾𒁀𒉌𒌓𒁺𒉈	SUX
𒊹𒀭𒀭𒀀𒀀	NEA
𒋫𒂍𒌷𒀜𒀭𒀀𒀀	NEA
𒊭𒀭𒁕𒃶𒈠𒀭	OLB
𒈤𒊒𒈨𒌍𒂊𒋩𒈨𒌍𒌓𒈬𒉺𒋡𒊑𒀀𒈾𒌋𒅗𒄭𒂍𒋗𒈫𒋫𒈬𒈨𒌍	LTB
𒄿𒋛𒂊𒋙𒆷𒀾𒆲𒉡	NEA
𒄿𒈾𒌨𒆠𒉌𒂊𒋾	NEB
𒀸𒌓𒈬𒌓𒊹𒄑𒊒𒁀𒇽𒈬𒌑𒌓𒈬𒈨𒌍𒃻𒌉𒃻	LTB
𒁹𒁀𒃻𒀀𒊹𒌑𒍑𒀭𒌑𒅎𒋛𒁲𒁕𒆠𒊒𒁀𒀀𒃻𒊹𒊹𒌑𒍑𒆠𒌑𒅎𒍇𒇻𒁕𒋻𒁀𒊍𒃻	LTB
𒀭𒌓𒅇𒀭𒀫𒌓	NEB
𒄿𒅆𒄑𒍝𒀪𒌋𒌆𒇻	NEB
𒅋𒇷𒆪𒉏𒈠	OLB
𒈩𒈬𒊬	SUX
𒊹𒀀𒀀𒀀𒊹𒀭𒀝	NEB
𒂗𒅀𒌌𒌀𒂗𒈾𒄠𒈨𒉌	NEB
𒀸𒊮𒁉𒆠𒇲𒀭𒂊	STB
𒊭𒂍𒀀𒊬𒉌𒉌𒉺𒋼𒋛	OLB
𒆪𒉡𒊌𒀪𒄿	LTB
𒀴𒀭𒀝	MPB
𒌝𒈠𒁹𒉿𒈪𒌑𒋫𒇽𒆳𒄞𒁕𒋗𒈾	MPB
𒀭𒂼𒈨𒌀𒈫	SUX
𒌝𒈠𒀸𒊹𒅆𒊺𒁇	NEB
𒁹𒊭𒀭𒌓𒅟𒇻𒈠	OLB
𒁹𒀭𒋾𒀪𒄿𒆪𒋢𒈗	LTB
𒇽𒂗𒈨𒌍𒌷𒄩𒇻𒇷𒂊	NEB
𒅖𒌅𒊭𒋗𒆷𒀀𒄿𒋡𒀠𒁹𒈗𒊒	MPB
𒅇𒀀𒈾𒈠𒄯𒁹𒀀𒈠𒀭𒄩𒀜𒁉𒄿𒊑𒁍𒈪	MPB
𒍑𒋫𒄴𒊒𒌒𒋫𒄴𒄩𒊏	STB
𒁹𒁲𒂊𒈪𒂊𒁲𒊑𒋢𒈗	LTB
𒉡𒍮𒁀𒀜𒆪𒇻𒇷	STB
𒁁𒅀𒀭𒅀𒀭𒌓𒅀𒋡𒁺𒋀𒈨𒌍𒅀𒅇𒌉𒈨𒌍𒅀	MPB
𒀭𒁲𒄀𒅕𒉌𒅎𒉏𒀭𒋗𒊑𒅔	SUX
𒊹𒈬𒊺𒍢𒋀𒌑𒀀	NEA
𒆳𒍮𒍢	NEA
𒈬𒈥𒊩𒋡𒀭𒉡	LTB
𒅋𒆷𒆪	NEB
𒆠𒂗𒍠	SUX
𒊹𒀸𒌗𒀳	STB
𒄿𒈾𒀭𒈾𒀀𒈾𒍢𒊑𒅀	MPB
𒁹𒀭𒀫𒌓𒂵𒅖	OLB
𒉡𒈠𒀜𒌑𒈾𒀀𒌓	STB
𒁹𒀹𒁯𒌝𒈪	OLB
𒆷𒈠𒁲𒈗	MPB
𒌅𒄤𒍝𒀠	STB
𒈥𒍝𒆪𒆷𒀀𒈠𒄥𒆷𒀠𒋃	NEA
𒌗𒊺𒂕𒌑𒈬𒊹𒌒𒋳𒆳𒋢𒈗𒆳𒆳	STB
𒃻𒊮𒁉𒋙𒌌𒄿𒁺𒌑𒆠𒄿𒁀𒉌𒋾𒅇𒆠𒄿𒆷𒁀𒉌𒋾	NEB
𒀀𒈾𒀜𒅟	NEB
𒂊𒆷𒉏𒈠𒀉𒈨𒌍𒀀𒈾𒆳𒌓𒁴	NEB
𒌗𒇯𒆬𒌓𒊹	SUX
𒀀𒀕𒆠	LTB
𒀴𒌋𒉺𒌓𒃻𒈗𒈨𒌍𒂗𒈨𒌍𒐊	NEB
𒀭𒉡𒋆𒈨𒌍𒋙𒉡	NEA
𒇷𒁓𒇷𒁕𒈥	MPB
𒌑𒈥𒊩𒈠𒀪𒀀𒁲𒊹𒀀𒈾𒀀𒃻𒀀𒈾𒌓𒈬𒍝𒀀𒌓	LTB
𒀭𒁉𒊺𒁀𒀩𒀭𒌓	SUX
𒇽𒌉𒈨𒊑𒄿𒉌𒀀𒈾𒉺𒉌𒉌𒌌𒄴𒄭𒊓	NEB
𒀀𒈾𒅀𒅆𒄿𒉡𒈠	MPB
𒀭𒀭𒇽𒍑𒆪	SUX
𒋙𒉡𒅖𒋙𒌑	NEB
𒈗𒀀𒊭𒊑𒁺𒌓𒁺𒀝	STB
𒀀𒊓𒌓	NEA
𒁹𒈗𒋀𒋙𒉡𒌑𒈾𒀪𒌑𒌑𒁖𒆪𒌋𒌋𒋙	NEB
𒋫𒉺𒀭	NEA
𒌨𒀭𒁀𒌑	SUX
𒃻𒌋𒌋𒊹𒈲𒈨𒌍𒀸𒋳𒍝𒀠𒌈𒊹𒌗𒋙𒉡𒋾𒍑𒋫𒉺𒊕𒈠𒀸𒌗𒃻𒁹𒁕𒇷𒁕𒀀𒁉	STB
𒇲𒂊𒉈	SUX
𒀀𒁉𒊭𒄀𒅖	OLB
𒌝𒈠𒁹𒀊𒁲𒈾	MPB
𒅇𒆷𒄿𒇷𒀪𒂊𒀀𒆷𒂵	MPB
𒋫𒅆𒇽𒈨𒌍𒂊𒀭𒉡𒋾𒅋𒆥	NEA
𒁹𒀀𒉋𒅕𒍢𒁴	OLB
𒌅𒊕𒇴	STB
𒀀𒈾𒋾𒆷𒍣𒈨𒌍𒋙	STB
𒉻𒄭𒀀𒈬𒈨𒌍𒀀𒈾𒁹𒀭𒌓𒈬𒉡𒀀𒈾𒌓𒈬𒍝𒀀𒌓𒈾𒋗𒌑	LTB
𒂍𒂗𒈨𒌍𒅀𒃮𒁉	NEA
𒂊𒋻𒁍𒄰𒈬𒋢𒅇𒆠𒄿𒀠𒌨𒌋𒉌	NEA
𒉌𒅋𒆷𒂵𒄠𒄿𒈾𒀭𒈾𒈠	MPB
𒇽𒆠𒅗𒈠	SUX
𒁹𒅋𒂁𒋾𒄿	LTB
𒀀𒉡𒈠𒄿𒈾𒀭𒈾𒁍𒄭𒅕	MPB
𒈗𒋾𒅀	STB
𒌋𒅗𒄯𒆠𒄿𒀠𒇷𒆠	NEB
𒁹𒁁𒂖𒋾𒌈𒆠	OLB
𒉆𒄩𒅈𒋾𒀭𒌓𒈬𒁀𒇷𒀉	OLB
𒅇𒊹𒈨𒆬𒌓𒈨𒌍	MPB
𒃻𒀀𒃻𒀀𒃻	LTB
𒉿𒑏𒑏𒑏𒑏𒑏𒍥𒁕	OLB
𒄑𒄑𒄑𒄑𒄑𒌋𒌋𒌋𒌋𒌋𒌋𒍑𒄭𒀀	SUX
𒈠𒀀𒁕𒆷𒆤𒋾𒀉𒋾𒈗𒀜𒅟	NEB
𒆳𒄿𒌅𒀪	NEA
𒊹𒊕𒀴𒈨𒌍	OLB
𒃻𒋠𒊕𒊹𒂗𒌆𒁺𒋙𒉡	NEB
𒊬𒊒𒌝𒁀𒉌	SUX
𒅀𒃻𒀸𒋗	NEB
𒈦𒈠𒈾𒆠𒇴𒄑𒊒𒁀𒌉𒃻	LTB
𒀭𒊩𒌆𒄈𒋢𒂗𒂗𒆤𒆠𒋫𒌓𒋤𒂠𒈤	SUX
𒄒𒋢𒆷𒈠𒀪𒁕	NEA
𒇽𒉆𒊭𒌷𒇹𒀭𒄠𒈥𒈠𒍮𒌋𒉌	NEA
𒃻𒉈𒈬𒌦𒉌𒀀𒈾𒈗𒂗𒅀	NEA
𒊭𒀀𒉌𒋫𒇷𒈪𒉺𒈥𒌅	OLB
𒊹𒃻𒀭𒀝𒋗𒌑	NEB
𒁹𒄿𒋺𒀭𒂗	LTB
𒉺𒆷𒄴𒀭𒁕𒁀𒀀𒉌	STB
𒀸𒂍𒈬𒈨𒌍𒄿𒍢𒌋𒈠𒀀𒁺𒈠𒆷𒁀𒋗𒌑𒃮𒁉𒅇𒌆𒄖𒅘𒆪	LTB
𒊹𒊹𒍑𒄭𒄭𒂗	MPB
𒈗𒂗𒅀𒄿𒉡𒈠𒇽𒀴𒅟	MPB
𒅇𒉌𒁍𒌑	NEB
𒄖𒋧𒆵𒄖𒋧𒄴𒈠	STB
𒆠𒄿𒌑𒊺𒅁𒉿𒍑	NEB
𒀀𒈾𒉺𒀭𒇽𒃲𒈨𒌍	NEB
𒀀𒈾𒀭𒁕𒈬𒁖𒆷𒆪	SUX
𒅎𒀀𒁕𒀜𒅎𒀭𒅎	STB
𒀀𒉡𒌝𒈠𒁹𒄩𒀀𒊏𒈠𒀸𒅆𒊭𒋀𒅀𒀀𒈠𒀀𒈾𒅀𒅆𒅖𒁍𒊒	MPB
𒉡𒀸𒅆𒈗𒂗𒐊𒀸𒁀𒅟	NEB
𒅗𒌤𒀀𒂗𒀭𒊩𒌆𒄈𒋢𒆤	SUX
𒁹𒄩𒉿	MPB
𒌓𒊹𒄰𒊺𒆰𒉻𒇻𒌌	STB
𒀀𒈾𒆳𒋢𒁀𒊑𒄿𒈾𒇻𒆥	MPB
𒍝𒀀𒌓𒈾𒋗𒌑𒂍𒈬𒈨𒌍𒃻𒀀𒃻	LTB
𒆠𒄿𒌅𒊒	NEB
𒀀𒈾𒌓𒈬𒍝𒀀𒌓𒀸𒀭𒁷𒁍𒌓𒀀𒄩𒀀𒈩𒀀𒈾𒈬𒊒𒄣𒃻	LTB
𒇽𒈾𒁷𒈾𒈨𒌍𒈪𒋻𒀸𒆠𒊒𒁀𒀀𒈬𒈨𒌍	LTB
𒉺𒋼𒋛	OLB
𒊮𒋗𒈬	SUX
𒊹𒌑𒍑𒆠𒌑𒅎𒍇𒇻𒁕𒂍𒌉𒃻𒊹𒌑𒊕𒆠𒀭𒋫	LTB
𒅇𒀭𒉡𒌑𒌋𒅗𒅀𒅖𒀠𒈪	MPB
𒃻𒀭𒆳𒂗	MPB
𒇽𒈬𒋾𒀀𒁀𒀠	OLB
𒀸𒋗𒈫𒌉𒃻𒈠𒆟𒂊𒋩𒌓𒈬𒉺𒋡𒊑𒀀𒈾𒌋𒅗𒄭	LTB
𒊹𒆦𒀭𒉈	STB
𒊹𒀯𒋗𒄀𒁹𒌋𒅗𒊹	STB
𒇽𒀊𒉣𒈾	OLB
𒂗𒀭𒈾𒁺	OLB
𒌉𒃻𒀀𒈾𒌓𒈬𒍝𒀀𒌓	LTB
𒀭𒄬𒆷𒀭𒆬𒀭𒂍𒀀	SUX
𒌉𒃻𒀀𒈨𒌍𒌉𒃻	LTB
𒊭𒀀𒈾𒇽𒊏𒆠𒄿	OLB
𒌋𒀀𒈨𒌍𒃻	LTB
𒊹𒀯𒊕𒈨𒃻𒀸𒊺𒅕𒋾𒅅𒌅𒌦	STB
𒅆𒀭𒈾𒆤𒍪	SUX
𒀀𒈾𒊹𒀭𒉺𒉽𒈨𒌍𒊩𒅆𒇽	NEA
𒊩𒌆𒀭	SUX
𒈠𒆟𒂊𒋩𒌓𒈬𒉺𒋡𒊑𒀀𒈾𒂍𒌋𒆠𒊒𒁀𒀀𒈬𒈨𒌍𒀉𒋰𒋗𒌑	LTB
𒀭𒉺𒊕𒂷	SUX
𒁾𒉿𒀀𒈾𒂄𒈪𒈗	NEB
𒅆𒊹𒇽𒃲	NEA
𒌑𒋀𒋛𒀀𒈠𒀸𒂍𒀭𒈾𒌑𒆥𒇽𒌝𒌋𒌋𒉡	STB
𒁹𒐊𒅆𒂊𒈬𒂵𒋗	OLB
𒊹𒊹𒉣𒇬𒌓𒆸𒌓	STB
𒊹𒉽𒁀𒉌𒇽𒄥𒁍𒋼	NEA
𒀀𒈾𒉺𒉌𒋾	NEA
𒁹𒅁𒆪𒊭	OLB
𒃻𒋗𒀭𒂗𒍪𒊺𒈪	OLB
𒌉𒅆𒅁𒊑𒀀𒈾𒌷𒍮𒈬𒊏	MPB
𒀀𒅟𒋗𒀀𒆷𒀀𒆪	STB
𒀭𒊺𒉀𒌨𒊕𒈫	SUX
𒌆𒍮𒉻𒋫𒋆𒈨𒌍𒌋𒄑𒈨𒌍𒊹𒀸𒍜𒁀𒊩𒌋𒁄𒂅	LTB
𒌝𒈠𒊩𒀀𒍢𒌓𒅆𒄿𒈪𒉡𒌑𒄭𒂅	NEB
𒀸𒌋𒅗𒄭𒀀𒇉	NEA
𒆷𒊍𒁀𒋢	NEA
𒈠𒀀𒇻𒌑𒁉𒇻𒌋𒌋𒋙	NEA
𒈗𒋙𒆳𒋢𒉽𒋙𒈠𒂊	STB
𒇷𒁉𒇻𒅇𒊮𒁉𒆳	NEB
𒊩𒌆𒇽	SUX
𒁹𒀭𒀫𒌓𒊑𒈠𒀭𒉌	OLB
𒁹𒀀𒄷𒅆𒈾𒇽𒋀𒀊𒆠	OLB
𒀀𒁲𒊭𒌉	NEA
𒊹𒊹𒉣𒇬𒆸𒆸𒈠𒀯𒂄𒉺𒌓𒁺𒀸𒊮𒋙𒁺𒄑	STB
𒌅𒋚𒁕𒀠	STB
𒌑𒍑𒊹	LTB
𒊹𒈨𒇽𒈨𒌍𒅇𒊹𒈨𒂟𒈨𒌍𒆳𒅟𒅆	MPB
𒀸𒀉𒊻	SUX
𒊹𒀭𒆛𒊺𒅕𒍣𒈾𒅆	STB
𒇥𒁀𒉌𒊒	SUX
𒊹𒌋𒈪𒋻𒌑𒍑𒆠𒌑𒅎𒍇𒇻𒁕𒈨𒌍𒉺𒃻𒉌𒌈𒃻𒂍𒈬𒈨𒌍𒌋𒁕𒂍𒌉𒃻	LTB
𒅆𒊒𒉈𒌍	SUX
𒀀𒈾𒁷𒌁𒆠𒀀𒌨𒀀𒈾	NEB
𒇻𒁍𒄩𒁕𒉌𒄿𒋳𒋢	NEA
𒍑𒇽𒉽	NEA
𒆰𒆪𒉡𒆰𒃻𒋀𒈨𒌍𒆪𒉡𒌉𒈨𒌍𒆪𒉡	STB
𒃶𒋾𒆷𒂠	SUX
𒀸𒊮𒋙𒀭𒉐𒈪𒂍	STB
𒆳𒉏𒈠𒆠𒃮𒁉𒉈𒂊𒈨	NEB
𒊺𒆠𒋢𒌓𒂊𒆪𒈝	NEA
𒄞𒈨𒌍𒋙𒉡𒇸𒌨𒌑𒉌	NEA
𒄯𒊕𒌦𒈠𒆠𒌗𒋝𒌓𒊹	LTB
𒌝𒈠𒈗𒌌	NEB
𒀀𒈾𒌓𒈬𒍝𒀀𒌓𒌋𒌉𒊩𒈨𒌍𒃻𒇽𒋀𒋙𒉡	LTB
𒇽𒃻𒌆𒃻𒌷𒈠𒋥	NEB
𒊹𒀀𒉌𒋙	LTB
𒀯𒉌𒁁𒀀𒉌𒈬𒋙𒇷𒄬𒇷𒄣	NEB
𒋗𒁹𒀭𒇽𒁾𒊬𒇽𒄬	MPB
𒀭𒌓𒈠𒄩	OLB
𒈗𒊑𒃲𒈗𒋫𒄠𒄩𒊏	MPB
𒅀𒉡𒊮𒁉𒊭𒈾𒀀𒈾𒅀𒅆	MPB
𒃻𒀭𒀫𒌓𒌋𒀭𒇡𒉺𒉌𒌈	NEB
𒀀𒈾𒌓𒋻𒋼𒋼𒋛𒅁𒋫𒉿𒄴𒄭𒋗𒈠𒀸𒋫𒀾𒉌𒂊	STB
𒊭𒀀𒉿𒅋𒉌𒉌𒌷𒊒𒆠𒌉𒅟𒁀𒅈𒌈	OLB
𒌓𒊹𒌓𒊹𒌓𒊹𒉽𒅆𒅖𒋙𒃻𒌓𒈬𒀸𒊹𒌓𒈬𒀸𒌓𒈬𒈨𒌍𒄑𒊒𒁀	LTB
𒉌𒉌𒄿𒁷𒉆𒊹𒊕𒊩𒆳𒈨𒌍𒊹𒊩𒌉𒊏	OLB
𒊭𒀀𒊭𒁉𒅕𒅖𒌅	MPB
𒆷𒃻𒀭𒃻𒁁𒀠𒌋𒉡𒋗𒌅𒌑𒄣𒃻𒋛𒌋𒌋𒉡𒀀𒁲𒌋𒅗𒄭	LTB
𒊹𒌓𒊹	STB
𒌓𒊹𒄰𒅖𒄷𒊏𒀭𒉌	NEA
𒀭𒈕𒉿𒆬	SUX
𒊹𒑛𒌑𒊕𒆠𒀭𒋫𒅎𒈥𒌅𒁕𒋻𒋝𒈬𒋳𒌦𒈨𒌍	LTB
𒁕𒋻𒋝𒈬𒋳𒌦𒈨𒌍𒊹𒌑𒊕𒆠𒆠𒋫𒅎𒆳𒊏𒁕𒂍𒀀𒋢𒌒𒁍𒈨𒌍𒃻	LTB
𒊭𒉌𒉌𒄿𒁷𒉆𒇽𒆷𒂵𒀸𒆠	OLB
𒊭𒋞𒈨𒌍𒇷𒄑𒍮𒊒𒈠𒀀𒀜𒌓𒉡	NEA
𒄑𒈬𒈾𒁖	SUX
𒀀𒈾𒉡𒉽𒈗𒆠𒈾𒈾𒈠	MPB
𒄩𒊏𒉿𒈗	NEB
𒌋𒌨𒁇𒊏𒈨𒌍𒇽𒍇𒇻𒄤	STB
𒀀𒉡𒌝𒈠𒀀𒈾𒆪𒅇𒁹𒄩𒋾𒅁	MPB
𒊭𒅖𒌅𒈾𒄰𒁴	OLB
𒁹𒂊𒊑𒅖𒋾𒀭𒀴𒊏𒊕𒊩𒆳	OLB
𒅋𒇷𒆪𒉏	OLB
𒂗𒀉𒆗𒇷	SUX
𒆳𒆗𒈾𒈾𒀸𒅆𒋙𒆠𒄿𒊮𒁉𒋙𒉡	NEA
𒅇𒉺𒈾𒅀𒀉𒁲	MPB
𒀀𒈾𒊭𒋗𒉡𒅇𒉿𒂖𒆠𒋗𒉡	MPB
𒀀𒋛𒈨𒈠𒀀𒌉𒊹𒈾𒁷	NEA
𒌑𒊓𒊍𒂍	NEA
𒌋𒍏𒊿𒌉𒀀𒈾𒊑𒄷𒄭𒌑𒌓𒀀𒈾𒊩𒊩𒆳𒅟𒀀𒂼𒋙	LTB
𒀭𒈨𒌍𒃻𒈗𒂗𒐊𒉡𒉌𒆷	NEB
𒉡𒀠𒌀𒁶𒅆𒂠𒊏𒁉	STB
𒈠𒆷𒁀𒋗𒌑𒃮𒁉𒀀𒈾𒊹𒂆𒆬𒌓𒋡𒇻𒌑	LTB
𒅇𒋳𒈠𒌷𒁺𒉌𒅁	MPB
𒃮𒁉𒃻𒀸𒇽𒆭𒂍𒌑𒌓𒅇𒇽𒄈𒇲𒌑𒌓𒅇𒀸𒍜𒁀𒀾𒇻	LTB
𒁹𒀭𒀫𒌓𒋾𒀀𒉌𒅅𒁉	OLB
𒌋𒀸𒁍𒁍𒌅𒆠𒄿𒀊𒌅𒌑𒃻𒄭𒀀𒀀𒅅𒋾𒋫	NEB
𒊭𒊑𒅎𒀭𒀹𒁯	OLB
𒆠𒊒𒁀𒀀	LTB
𒋻𒁲𒋾𒌌𒌅𒂊𒇷𒉌	NEB
𒀸𒆗𒇷𒂊𒃻𒉘𒉌𒅟	NEB
𒂗𒈾𒀀𒈾	NEB
𒌉𒀭𒂗𒀭	OLB
𒁹𒃻𒋧𒈬	LTB
𒌓𒉽𒂠𒇽𒇽𒊏	SUX
𒀀𒈾𒈨𒌍𒊭𒊒𒌓𒂊𒁍𒍑	MPB
𒁹𒀭𒌓𒌈𒆠	OLB
𒀭𒈗𒀉𒁍𒁕𒈫	SUX
𒊭𒀭𒀫𒌓𒈾𒈲	OLB
𒄠𒈥𒊭𒈗𒁁𒉌	NEA
𒀀𒌉𒃻𒌉𒃻𒌉𒃻	LTB
𒅇𒂊𒈾𒍝𒅈𒌷𒌅𒁉𒄭	MPB
𒇽𒋃𒌉𒃻𒀀𒀕𒆠𒌗𒁈	LTB
𒈾𒋼𒀀𒌅	MPB
𒀸𒊮𒌷	NEA
𒃻𒀀𒈾𒄑𒊒𒁀𒈨𒌍𒈬𒈨𒌍𒅅𒁉𒅆𒁺𒃻𒆠𒌋𒂗𒈨𒌍𒄩𒆷𒋙	LTB
𒁈𒆠𒌀	SUX
𒀀𒃻𒇽𒉌𒃮𒂍𒃻𒂵𒊹	LTB
𒀖𒁺𒋰𒋢𒌋	STB
𒌅𒈜𒊐	STB
𒀭𒂗𒆤𒀭𒈦𒌋𒀭𒉺𒌆	NEB
𒄑𒈩𒆠𒅔𒄀𒊏𒄷𒆷𒈨𒋢	STB
𒈾𒍮𒌋𒉌𒀀𒈾𒈠𒊬𒋼	NEA
𒀀𒈾𒀭𒊩𒌆𒅁𒄿𒁷𒉆𒋃	OLB
𒊹𒌋𒊹𒀀𒈾𒄊𒈨𒌍𒈗𒂗𒅀𒄠𒋻	MPB
𒊹𒀯𒀸𒁁𒀯𒃻𒄴𒊒𒌝𒈠𒅆𒅕	STB
𒌌𒃻𒋗𒊹𒅀𒃮𒁉𒃻𒋗𒊹𒋀𒐊	NEB
𒌑𒊕𒉌𒅖	NEA
𒆠𒈗𒃻𒍪𒋫	SUX
𒊹𒀯𒃲𒋫𒀭𒌓𒌓𒁺𒀀	STB
𒉆𒄩𒅈𒋾	OLB
𒀀𒈾𒆪𒅇𒁹𒄩𒋾𒅁	MPB
𒊭𒈗𒁁𒉌𒐊𒊮𒁍𒊭𒈗𒁁𒉌𒐊	NEA
𒈬𒍮𒌑𒈠𒄠𒇻𒉌𒇲𒇷𒊑𒆭𒌋𒌓𒁺𒀀𒀀𒈾𒌓𒈬𒍝𒀀𒌓𒀭𒈾𒀀𒄩𒆷	LTB
𒅋𒋫𒀮𒉺𒊒𒌋𒌋𒋙	NEB
𒉈𒀸𒆠𒋫𒆪𒌑𒊑𒊬𒄴𒈠	STB
𒌷𒌌𒆷𒍝𒌷𒊭𒉿𒉿𒅆𒊒	MPB
𒌑𒂵𒈪𒅕𒇽𒈨𒌍𒊭	MPB
𒋗𒆸𒆸𒍑𒈨𒌍𒌋𒊕𒆠𒈪𒋚𒋾𒄩𒆷𒈬𒈨𒌍𒈪𒋻𒀸𒂍𒋗𒈫𒌋𒊒𒄖𒁍𒋙𒀸𒆍𒉌𒊑𒁉𒃻𒂍𒀊𒃲	LTB
𒊹𒊩𒊮𒄞𒈾𒊏𒄠𒌈	OLB
𒀀𒊒𒌝𒀀𒆷𒆪	STB
𒊏𒁉𒌅	MPB
𒋫𒂊𒄈𒋾𒋗𒉡	NEA
𒇽𒉽𒆗𒉡𒄑𒆪𒈨𒌍𒋙𒁹𒆳𒅍	STB
𒊮𒄑𒆵𒆠𒂠	SUX
𒊹𒊕𒊩𒆳𒈨𒌍𒀀𒈾𒊩𒍑𒁇	OLB
𒁹𒀭𒅖𒄩𒊏𒄖𒌝𒇷𒅀	OLB
𒇻𒌋𒁲𒈬𒀀𒈾𒈗𒁁𒅀	NEA
𒀭𒉡𒌑𒀀𒈾𒋗𒋼𒅕	MPB
𒈗𒇺𒀪𒀠	NEB
𒊭𒌨𒁓𒀭𒉌𒈠𒀀𒇽𒀀𒈨𒊑𒊭𒊹𒌨𒁄𒀀	NEA
𒊹𒈪𒅆𒄴𒀯𒋫𒅎𒆳𒊏	STB
𒈬𒈨𒌍𒊩𒋙𒃻𒌓𒈬𒇽𒈬𒌑𒌓𒌋𒇽𒄯𒌑𒌓𒀀𒁲𒌋𒅗𒄭	LTB
𒌉𒃻𒌋𒌉𒃻𒀀𒃻𒀀𒈨𒌍	LTB
𒀜𒊑𒅟𒀸𒌷𒂦𒂗𒀭𒀀𒀀	NEA
𒀭𒈪𒆳𒁉𒅆𒄿	STB
𒄿𒋫𒄷𒋙𒄑𒇀𒌋𒀲𒆳𒊏𒈨𒌍	NEB
𒁹𒆷𒀊𒀀𒅀𒀀𒁉𒅀	MPB
𒊹𒇽𒈾𒁷𒂍𒈬𒈨𒌍𒀀𒃻𒁹𒊑𒉺𒆠𒀉𒋾𒀪𒀸𒋗𒈫𒁹𒀭𒌓𒋩𒈠𒆟𒂊𒋩	LTB
𒅎𒈥𒌅𒁕𒁹𒄭𒂵𒅎𒀭𒂗𒌋𒁕𒂍	LTB
𒁹𒀭𒁀𒉌𒂊	SUX
𒅁𒁍𒋗𒅆𒁉𒅕𒋾𒈗𒊑	MPB
𒆷𒈬𒌑𒀀𒁳𒁍𒅁𒋫𒉡𒌑	NEB
𒁲𒈬𒀀𒈾𒌷𒄬𒍮𒉈𒈬𒊭𒈗	NEA
𒊮𒁍𒊭𒈗𒁁𒉌𒅀	NEA
𒄑𒄩𒄯𒁕	SUX
𒌗𒀳𒃮𒀀𒌓𒊹	OLB
𒀭𒍝𒄠𒈠𒄷𒌦𒁲𒀩𒅗𒉈𒉈𒈬𒌝	SUX
𒇷𒁍𒆪𒍑𒋙𒉡𒁴𒈠	NEB
𒀸𒆳𒄩𒈠𒋼𒄿𒇻𒆪	NEA
𒆠𒄿𒄑𒁀𒌅𒀀𒈾𒈗𒆳𒉏𒈠𒆠	NEB
𒀀𒃻𒊹𒈪𒋻𒌑𒊕𒆠𒆠𒋫𒅎𒆳𒊏𒁕𒈬𒍮𒌑𒃻𒁉𒈩𒋙𒉡𒈨𒌍𒉺𒃻𒉌𒌈𒃻𒋻𒁀𒊍	LTB
𒇽𒁲𒌇	SUX
𒁾𒉺𒄠	OLB
𒆬𒌓𒀸𒌋𒅗𒄑𒊭	NEA
𒅇𒉿𒉿𒊭𒊏𒈗𒊒𒂟𒈨𒌍	MPB
𒇽𒍇𒆗	NEA
𒅆𒊹𒂗𒌋𒌋𒉽	NEA
𒁹𒀭𒁕𒃶𒈠𒀭𒌑𒊭𒊑𒄠𒆜𒊹	OLB
𒄿𒋛𒄖	NEB
𒀀𒈾𒌉𒊹𒅀𒁺𒅅𒁲𒁉	NEA
𒊕𒍑𒂍𒆳𒊏	SUX
𒀭𒊬𒊏𒀀𒄭𒌈𒌋𒀭𒈨𒌍𒂍𒋙𒉡𒃮𒁉𒄑𒊒𒁀𒈬𒈨𒌍	LTB
𒅅𒁉𒀀𒈾𒊹𒃻𒈬𒋙𒃻𒉡𒌑𒌉𒃻	LTB
𒈬𒌅𒍑𒉿𒌅𒋗	STB
𒀀𒁲𒆷𒅖𒊬𒊑𒄣𒅇𒆠𒄿	NEB
𒂍𒂷𒉣𒈤	SUX
𒀭𒌑𒂁𒌜𒌑𒌇𒆪	SUX
𒌉𒀀𒀀𒆗𒆷	SUX
𒊹𒊕𒊩𒈨𒌍	OLB
𒆳𒀸𒋩𒉌	NEB
𒀭𒀭𒆗𒁕𒊏𒋼𒀀𒊏𒀭𒌍	SUX
𒈗𒅀𒉡𒈪𒅎𒈠𒀀𒈾𒅀𒅆	MPB
𒅇𒀀𒈾𒆪𒀴𒅟𒄿𒀫𒊒	MPB
𒇽𒀊𒉣𒈾𒆠	OLB
𒆷𒁷𒆷𒋗𒌓𒊹𒅆𒀀𒊮	NEA
𒊓𒈾𒁍𒊏𒄩𒍮𒃻𒌨	STB
𒌓𒊹𒄑𒊒𒁀𒇽𒆭𒂍𒌑𒌓𒈬𒈨𒌍𒀉𒋰𒋗𒌑𒀀𒃻	LTB
𒀀𒈾𒅆𒁾	OLB
𒀭𒉡𒊑𒊹𒀊𒉌𒄿	NEA
𒐕𒁹𒁹𒁹𒁹𒁹𒁹𒁹𒁹𒃻𒁹𒁹𒌑𒄑𒍣𒂼𒁉𒁹𒁹𒁹𒁹𒁹𒌑	SUX
𒃻𒀭𒌓𒌋𒀭𒀫𒌓	NEB
𒁁𒇷𒅀𒊹𒅇𒊹	MPB
𒇽𒅗𒈠𒁉𒁀𒊑𒊑𒄀𒌍𒀀𒀭	SUX
𒈨𒇴𒈬𒌑𒅋𒇻𒆪	STB
𒈠𒀀𒁖𒌅	NEA
𒂊𒋩𒀪𒌓𒈬𒉺𒋡𒊑𒁹𒌋𒅗𒄭𒈪𒋻𒀸𒆠𒊒𒁀𒀀	LTB
𒀭𒂍𒀀𒀭𒂍𒀀	MPB
𒀀𒈾𒆪𒌨𒂠𒊹	MPB
𒀀𒈾𒁕𒁀𒁉𒀀𒈾𒈠𒄯𒁹𒄩𒈬𒉌𒊑	MPB
𒀯𒊕𒈨𒃻𒀯𒀸𒁁𒀯𒆕𒋛𒁲	NEB
𒊩𒉽𒃻𒀭	STB
𒊏𒁕𒀀𒆪𒈲𒅆𒉡𒌇𒌒𒁍𒌓𒋾	STB
𒀀𒈾𒆬𒌓𒄿𒁄𒆷𒀠	STB
𒁹𒈗𒁁𒇷𒅀	MPB
𒊑𒄴𒋾	NEA
𒇽𒈨𒌍𒊭𒌷𒁺𒌒𒆷𒀀𒈾𒅀𒅆	MPB
𒇷𒇷𒆪	NEA
𒅇𒁹𒀀𒈠𒀭𒄩𒀜𒁉𒇽𒌷𒌅𒊩𒋾𒆠	MPB
𒀀𒊕𒆠𒀭𒋫𒅎𒈥𒌅𒁕𒋻𒋝𒈬𒌇𒀀𒇉𒀭𒈹	LTB
𒊹𒇽𒋃𒀀𒃻𒀀𒀕𒆠𒀉𒋗𒆚𒌓𒊹	LTB
𒌝𒈠𒌓𒈬𒆠𒋫	NEB
𒄿𒈾𒇽𒀴𒌈𒋾𒊭𒈗𒀭𒌓𒁁𒉌𒅀	MPB
𒀸𒅆𒅟𒅁𒋾𒌌𒁹𒆪𒌑	NEB
𒈠𒆟𒂊𒋩𒌓𒈬𒉺𒋡𒊑𒀀𒈾𒌋𒅗𒄭𒅆𒅔𒍣𒊒𒌑	LTB
𒌅𒄬𒆷𒀾	STB
𒇽𒊑𒋛𒅔𒉡𒌑𒌓𒀀𒁲𒌋𒅗𒄭𒊹𒈬𒀭𒈾𒈨𒌍𒄿𒊩𒅆𒈠	LTB
𒊹𒐞𒐞𒐞𒂟	SUX
𒊹𒊹𒁦𒆸𒆸𒆳𒁉𒂼𒌍	STB
𒀴𒈨𒌍𒅟	MPB
𒅎𒈨𒌍𒄭𒂵𒈨𒌍𒁺𒈨𒌍	STB
𒈗𒃲𒌀	STB
𒀭𒂗𒀭𒀫𒌓𒀀𒈾𒈗𒂗𒅀	NEB
𒅇𒁕𒀀𒉺𒁕𒀭𒉌𒅖𒈠𒀀𒈠𒀀𒋾𒋗𒊭𒋀𒅀𒆠𒄿𒊭𒋀𒅀𒈠	MPB
𒆠𒄿𒁉𒅅𒀭𒂗𒍪𒋫	SUX
𒀴𒅟𒊹𒂦𒀭𒀸𒋩	NEA
𒉆𒋾𒁉𒂠	SUX
𒋙𒅍𒅆	STB
𒌋𒊹𒌇𒅆𒀭	NEB
𒀀𒈾𒈗𒄿𒈾𒀾𒋙𒌑𒊹𒁍𒁕𒈾𒌓𒍝𒋫	NEB
𒀀𒈾𒈾𒄰𒁴	OLB
𒊭𒋝𒀭𒉡𒉌𒌈𒉺𒋼𒋛𒀭𒌓	OLB
𒀭𒊩𒌆𒉌𒊓𒀀𒀭𒌓	SUX
𒇽𒉿𒊹𒇲𒇽𒄩𒈬𒊏𒀀𒅅𒋫𒁀𒀾𒋙𒌝𒈠𒊹𒀭𒊹𒁷𒋢𒂊	NEB
𒊹𒌉𒊩𒃮𒌝𒈪𒌉𒊩𒇻𒇷𒈬𒌦𒇷𒁓𒊏	OLB
𒁮𒀵𒀭𒋀𒆠	SUX
𒀭𒈥𒌅	OLB
𒃻𒆠𒊹𒋀𒀜𒋙𒉡𒀀𒃻𒊹𒅅𒁉𒅆𒁺𒋗𒉡𒌓𒄩𒆷𒋙𒉡	LTB
𒊭𒂍𒀀𒁁𒂖𒉌𒉌	OLB
𒅖𒌅𒆳𒆠𒈗𒁁𒅀	MPB
𒄑𒉿𒌆𒋧𒈠	SUX
𒉌𒄷𒊒𒉡𒊌𒋧𒈬𒀸𒉺𒉌𒅟	NEA
𒆪𒊹𒀸𒈦𒈠𒈾	STB
𒀭𒊩𒌆𒅆𒂍𒈫	SUX
𒀀𒈾𒃻	OLB
𒀀𒀸𒆳𒋼𒀀𒀠𒆷	NEA
𒁹𒈗𒊑𒂗𒅀𒉿𒅅𒁉	MPB
𒌉𒊹𒀭𒅎𒈬𒀳𒌍𒅋𒋫𒌓𒌌𒄴𒍝𒀜	NEB
𒄞𒄭𒀀𒊹𒇻𒈨𒌍𒀀𒈾𒌋𒅗𒄭𒋙𒉡	NEB
𒁹𒅀𒀭𒄩𒈨𒅇𒀀𒈾𒁹𒁉𒄷𒊏	MPB
𒅖𒁓𒌋𒉌𒈠𒀀	NEA
𒋾𒀀𒄯	MPB
𒌓𒀊𒄈𒍪	SUX
𒀭𒀀𒄷𒌑	SUX
𒋙𒂟𒈨𒌍𒀭𒉡𒋾	NEB
𒊹𒈠𒈾𒀭𒉈𒊹𒂆𒉆𒊒𒌈	STB
𒀸𒉺𒆪𒅇𒄿𒆷𒂵𒄠𒈗𒆳𒄩𒀜𒋼	MPB
𒀀𒈾𒈪𒉌𒋾𒅟	MPB
𒊹𒊕𒊩𒆳𒀴𒌉	OLB
𒄭𒇷𒁀𒀭𒊭𒅟𒆷𒈠	SUX
𒀴𒆠𒋾𒋗𒅇	MPB
𒉆𒄯𒋾𒁹𒅔𒉡	OLB
𒀸𒀭𒁷𒄑𒊒𒁀𒈨𒌍𒈬𒈨𒌍𒃻𒊹	LTB
𒌋𒅗𒌷𒍮𒈬𒌨𒀀𒄯𒀀𒈾𒆪	MPB
𒋗𒆸𒆸	STB
𒉌𒄑𒋛𒉌	NEA
𒃻𒀀𒌨	NEB
𒊹𒀀𒈾𒉚𒌀𒈨𒌍𒀀𒈾𒀀𒃻𒀀𒃻𒀀	LTB
𒉌𒉌𒆠𒅁𒊑	OLB
𒆳𒌵𒆠𒈠	NEA
𒌓𒊹𒆚𒌓𒊹𒆚𒄞𒀸𒅆𒀭𒀝𒄿𒋻𒊏𒊍	STB
𒇽𒆍𒀭𒈾𒆤	SUX
𒈦𒅆𒌅𒊭𒆷𒀀𒊭𒋥𒊺𒂊	STB
𒋗𒊑𒀀𒊕𒂷𒄰	SUX
𒁹𒅖𒊭𒌈	OLB
𒃻𒇽𒇷𒀪𒋫𒈬𒇸𒇷𒆚𒈠	NEB
𒀀𒈾𒌷𒁉𒊏𒀀𒋾	NEB
𒀀𒈾𒑚𒈠𒈾𒊹𒂆𒆬𒌓𒄑𒋫𒌁𒊑𒈨𒌍𒃻𒁹𒀭𒋾𒀪𒄿𒆪𒋢	LTB
𒄑𒊒𒁀𒈬𒈨𒌍𒀀𒈾𒆬𒌓𒀀𒈾𒊑𒄷𒄭𒌑𒌓𒀀𒈾𒉡𒂄𒉡𒌑𒌓𒀀𒈾𒆕𒍑𒍮𒁍𒌑𒌓	LTB
𒇽𒆥𒄄𒀀𒌓𒀕𒆠	OLB
𒅇𒄿𒇷𒆠𒉌𒅖𒌅𒆠	MPB
𒀭𒋆𒁉𒍣𒀭𒌈𒀭𒅖𒋻	SUX
𒌅𒄬𒇲	STB
𒀀𒈾𒋃𒈨𒌍𒌗𒌑𒋫𒊬	STB
𒀸𒌗𒆥𒂍𒁉𒌀𒁇	STB
𒆠𒂍𒇽𒋾𒋫	SUX
𒅇𒆷𒀀𒀀𒆗𒇷	MPB
𒀸𒄷𒌓𒊮𒁉𒋙𒌓𒊹𒄑𒊒𒁀𒋙𒇽𒄈𒇲𒌑𒌓𒅆𒊹𒀭𒌈𒀭𒈹𒀭𒈾𒈾𒀀𒀭𒃽𒃻𒊕𒌋𒀭𒈨𒌍𒂍𒋙𒉡𒃮𒁉	LTB
𒀭𒀝𒄩𒁹𒀮𒇺𒈠𒆠𒋻𒊏𒁀𒈗𒋾	STB
𒀭𒄿𒉈𒀭𒂗𒍪𒄘𒃲𒉆𒉣𒈾	SUX
𒈬𒁺𒀀𒈾𒂍𒀀𒋛𒊑	OLB
𒀴𒀭𒅅𒃲𒆷	OLB
𒊭𒀀𒈾𒀭𒀫𒌓𒈾𒍢𒅕𒊮𒀀𒇉𒀀𒋩𒀸	OLB
𒇽𒀳𒋙𒀸𒂔𒀀𒀀𒅋𒊓𒀀𒀀𒆷𒆷	STB
𒇽𒌷𒈾𒆠	OLB
𒌨𒆠𒆗𒁉𒌨𒍮𒄭𒋢𒌑	STB
𒁹𒀭𒋗𒁀𒉌	OLB
𒀸𒌗𒁈𒀀𒈾𒁷𒌁𒆠	NEB
𒁹𒀭𒈾𒈾𒀀𒈬𒃻𒌋𒊹	LTB
𒌁𒌁𒀭𒈾	STB
𒆠𒈫𒃻𒌑𒈨𒌑𒈠𒌋𒅗𒌦𒈨𒌍𒄿𒄭𒊒	STB
𒋗𒊹𒋙𒌋𒄊𒊹𒋙𒈛𒋛	STB
𒅇𒋳𒈠𒁕𒊭𒀝𒂵𒀭𒀭𒈬𒌓𒋾𒀀𒉿𒋼𒈨𒌍	MPB
𒊑𒅖𒂊𒊑𒋗	MPB
𒁹𒋡𒉌𒄭𒂵	SUX
𒆷𒀾𒋙𒀀𒅟𒀭𒉌𒈠	NEA
𒀸𒌓𒊹𒌓𒊹𒄑𒊒𒁀𒇽𒆭𒂍𒌑𒌓𒈬𒈨𒌍𒃻𒌉𒃻	LTB
𒈨𒌍𒈬𒈨𒌍𒄑𒊒𒁀𒋙𒇽𒄊𒋧𒂵𒌑𒌓𒅆𒊹	LTB
𒆳𒆠𒈨𒌍𒅇𒀭𒉡𒍑	MPB
𒌉𒊩𒈨𒌍𒆪𒉡𒀸𒉿𒌀𒋾𒇷𒄴𒈾𒄣𒆪𒉡	STB
𒁹𒌑𒁇𒌉𒃻𒊹𒀀𒁹𒂠𒍪𒌑	LTB
𒊭𒈬𒈾𒉿𒀸𒁾𒊬𒆠𒋢𒇻𒂠𒃻	OLB
𒋙𒉡𒈬𒃻𒀭𒉌𒅀	NEB
𒀭𒀫𒌓𒉺𒇻𒆳𒋗𒋻𒆍𒃲𒀭𒀫𒌓	STB
𒀀𒈾𒆠𒋩𒊏𒆠	OLB
𒆷𒆠𒄿𒅇	MPB
𒅆𒅖𒋙𒀸𒆠𒊒𒁀𒀀𒆠𒁴𒆍𒃲𒃻𒆠𒆗𒀕𒆠𒊹𒌑𒍑	LTB
𒀭𒂗𒍪𒊺𒈪	OLB
𒋢𒌓𒂵	SUX
𒈠𒆷𒀸𒁾𒉿𒀭𒉌𒂊𒈬𒋙𒉡𒍠𒊒	STB
𒀭𒈨𒌍𒂍𒋙𒉡𒃮𒁉𒅆𒅖𒋙𒃻𒊹𒌓𒈬𒀸𒌓𒊹𒌓	LTB
𒀭𒈹𒅟𒆤	SUX
𒊮𒁀𒃻𒊩𒍑𒁲	SUX
𒆠𒆪𒀭𒋗𒍣𒀭𒈾	SUX
𒅆𒌓𒋾𒃻𒈗𒀀𒈾𒌷𒂍𒂊𒈮𒀀𒉡	NEB
𒊹𒌉𒊏𒀜𒆗𒀀𒈾𒀭𒀫𒌓	OLB
𒁕𒀀𒈾𒀀𒆗𒌋𒌋𒄑𒋛𒌋𒌋𒇽𒊩𒋢𒈨𒌍	NEA
𒊹𒈦𒌑𒍑𒀭𒌑𒅎𒋛𒁲𒁕	LTB
𒁹𒀭𒈾𒈾𒀀𒈬𒁍𒌑𒌓𒀀𒄩𒀀𒈩𒀀𒈾𒈬𒌨𒊒𒄣𒃻𒄑𒊒𒁀𒈬𒈨𒌍𒁹𒀭𒈾𒈾𒀀𒈬	LTB
𒅎𒆳𒊏𒁕𒈬𒍮𒌑𒃻𒂍𒈬𒈨𒌍𒂍𒌋𒆠𒊒𒁀𒀀𒈬𒈨𒌍𒄿𒍢𒌋𒈠𒀀𒁺	LTB
𒍑𒆪𒀭	SUX
𒁮𒀭𒊏	SUX
𒁹𒀀𒂵𒀠𒀀𒈾𒁁𒂖𒁴	OLB
𒊹𒇽𒍑𒁇𒌋𒊹𒊹	LTB
𒀭𒂗𒌋𒀭𒉺𒈗𒁲𒉌𒃻𒀴𒋙	NEB
𒁹𒀭𒈹𒈬𒆚𒇽𒋃𒌉𒃻𒀀𒀕𒆠𒌗𒋗𒌓𒊹𒈬𒊹𒁹𒋛𒇻𒆪𒈗	LTB
𒇷𒊑𒁍𒌋𒌓𒁺𒀀𒀀𒈾𒌓𒈬𒍝𒀀𒌓𒀭𒈾𒀀𒄩𒆷𒃻𒌋𒌉𒈨𒌍𒃻𒀀𒀀𒈾𒌓𒈬𒍝𒀀𒌓𒅆𒋾	LTB
𒅖𒈨𒀭𒂗𒍪	OLB
𒈥𒅀𒉡𒈠𒀀𒈾𒅀𒅆	MPB
𒇻𒌋𒇽𒅈𒈠𒀀𒀀	NEA
𒇷𒅖𒈨	MPB
𒅇𒍜𒁀𒀠𒂅𒃮𒁉𒃻𒇻𒀴𒃻𒅆𒀭𒉽𒈛	LTB
𒅇𒆏𒁉𒇽𒈨𒌍𒅆𒂗𒈾𒁉𒌅	MPB
𒀀𒈾𒈗𒁁𒉌𒅀𒀴𒅟𒊹𒉣𒆷𒀀𒀭𒂗𒆤	NEB
𒊭𒀭𒈾𒁉𒌝𒄩𒍣𒅕𒄴𒈨𒌒𒇴	OLB
𒁹𒋼𒁺𒌝𒆠	OLB
𒊭𒀴𒊏𒈾𒍢𒅕	OLB
𒆠𒄿𒀾𒈬𒌑𒄑𒍝𒁁𒋢	NEB
𒀭𒀭𒌤	SUX
𒈾𒉿𒅕𒁁𒉌	OLB
𒊕𒀀𒀀𒉡𒍑𒅟𒀀𒀀𒉡𒃻𒌋𒌋𒊕𒊑𒌍𒍑𒆰𒇻	STB
𒂆𒍑𒊕𒈗	OLB
𒀭𒊩𒌆𒈹𒂞𒆠𒊏	SUX
𒌦𒈨𒌍𒅀𒌑𒄬𒋃𒇽𒀀𒆥	NEB
𒌓𒊹𒈬𒊹𒁹𒀭𒋾𒀪𒆪𒋢𒈗	LTB
𒀀𒃻𒌋𒁕𒂍𒀀𒃻𒌋𒁕𒂍	LTB
𒅇𒈬𒋾𒀭𒁕𒃶𒋰𒉿𒋗	OLB
𒀀𒈾𒌉𒃻𒌉𒃻𒀀𒈾𒌓𒈬𒍝𒀀𒌓𒀉𒋫𒁷	LTB
𒀭𒇴𒀳𒌉𒄿𒉡	OLB
𒋫𒃮𒁉𒌍𒁇𒁹𒈗𒀀𒂵𒉈𒆠𒋫𒉆𒁷𒌗𒁈	STB
𒂍𒌋𒌆𒁀𒉌𒋙𒌋𒂍𒊒𒄖𒁍𒋙𒌈𒋙𒃻𒂵𒊹𒂍𒈩𒋾𒋙𒃻𒀸𒆠𒁴𒂍𒀊𒃲	LTB
𒊭𒉌𒌓𒁁𒉌𒁹𒅀𒀭𒄩𒈬	MPB
𒊭𒀭𒂗𒍪𒂍𒃲𒇷𒉺𒇻	OLB
𒈛𒀭𒀀𒉡𒉌𒌈	STB
𒇽𒈛𒂗𒋙𒇻𒌋	NEB
𒀴𒊭𒃲𒁉𒈜	NEA
𒅴𒋙𒄿𒊑𒇲𒌅	STB
𒀭𒊩𒌆𒅟𒁺	SUX
𒀸𒌋𒅗𒃮	NEA
𒂵𒀸𒋫𒆪𒄿𒈾𒄩𒄷𒄭𒅖	MPB
𒀀𒈾𒈠𒄯𒀴𒈨𒌍𒋗𒊭𒄿𒋗𒌑	MPB
𒇽𒈥𒊑𒋡𒀭𒆠𒊒𒁀𒀀	LTB
𒁁𒉌𒇷𒅕𒄭𒍝𒀾𒋙	NEA
𒈠𒀀𒂍𒈨𒌍𒊭𒂊𒁍𒋗𒉌	NEA
𒅇𒋗𒁉𒆷𒀸𒋗𒉡𒋾𒀀𒈾𒈗𒂗𒅟	MPB
𒄿𒈾𒆳𒅅	STB
𒈨𒌍𒃻𒀀𒃻𒀀	LTB
𒄑𒋃𒋼𒆕𒍑𒈠	STB
𒊩𒌆𒉾𒊓𒊏	SUX
𒆠𒈠𒌷𒅕𒋡𒋫	MPB
𒅅𒁍𒌋𒉌𒈠𒀀	NEA
𒅇𒉿𒂖𒆠𒋗𒉡	MPB
𒊹𒀀𒋙	LTB
𒌷𒈠𒊏𒀜𒌌	NEB
𒉺𒉌𒋗𒉡𒀀𒈾𒈬𒄭𒋗𒉡	MPB
𒌑𒌌𒀀𒄩𒋫𒋗𒈠𒀭𒉡	MPB
𒈠𒀀𒈾𒄴𒊑𒁲𒀀𒋫𒀀	NEA
𒌉𒃻𒀀𒈨𒌍	LTB
𒌉𒃻𒊹𒀀𒁹𒂍𒆳𒍝𒄫𒊹𒊹𒌉𒃻	LTB
𒌝𒈠𒁹𒅈𒋫𒈠𒀭𒉿	MPB
𒇻𒊩𒅆𒈨𒌋	NEA
𒌉𒊩𒈨𒌍𒆪𒉡𒀸𒋗𒊹𒆪𒉡𒆷𒋫𒂟𒁀𒋫	STB
𒀸𒉺𒆪𒅇𒇻𒌑𒄿𒊬𒊏𒁍𒉏	MPB
𒂍𒈩𒋾𒋙𒃻𒀸𒆠𒁴𒆏𒊑𒃻𒂍𒀭𒈨𒌍𒃻𒆠𒆗𒀕𒆠𒊹𒌑	LTB
𒌅𒂷𒈛	STB
𒋗𒆪𒊻𒃰𒂅𒉿𒄿𒄑𒍢𒅆𒅕𒈬𒀸𒊮𒋼𒀊𒉆	STB
𒀀𒋾𒁷𒁲𒈬	NEA
𒊹𒌉𒊩𒃮	SUX
𒆷𒅅𒁍𒌑𒌌𒄿𒆠𒁍𒅔𒉌	NEB
𒆠𒄿𒄴𒄭𒊓𒋗𒈝𒋙𒉡	NEB
𒇽𒃻𒉡𒋼𒇽𒀊𒁀𒈨𒌍𒊭𒌷	NEA
𒌋𒌆𒇻𒌑𒆪𒋙	NEA
𒋳𒈬𒇽𒈪𒉭𒀸𒇽𒄷𒌒𒋾	NEA
𒀀𒈾𒋗𒈫𒀭𒈨𒌍𒃲𒈨𒌍𒌑𒆥𒉡	STB
𒀲𒅆𒍑	SUX
𒊭𒄘𒀀𒇉𒄑𒄀𒉏	OLB
𒀭𒊹𒊭𒌷𒀏𒆠	NEA
𒀀𒉿𒅋𒀭𒅎𒉺𒈥𒌅𒇽𒀊𒉣𒈾𒆠	OLB
𒌓𒀊𒀊𒈨𒌍𒀀𒈾𒄑𒍎𒃻𒀭𒂗𒆤𒇯𒁺𒌑𒀸𒍜𒃻𒇻𒀴𒈨𒌍	LTB
𒁹𒀀𒈠𒀭𒄩𒀜𒁉𒄿𒊑𒁍𒉌𒇽𒊓𒄤𒈨𒌍	MPB
𒀭𒊩𒌆𒅁𒌋𒀭𒉺𒌆𒀀𒈾𒈗𒁁𒉌𒅀	NEB
𒀭𒊩𒌆𒄈𒋢𒋗	SUX
𒊭𒄩𒁕𒀭𒋗𒇷𒅅𒋗𒌓	OLB
𒈫𒄞𒁆𒀭𒊩𒌆𒋚𒆤	SUX
𒇽𒆥𒄄𒀀𒈨𒌍𒌓𒀕𒆠	OLB
𒋫𒊮𒀴𒈨𒌍𒋙	NEA
𒁹𒄩𒈪𒀉	OLB
𒀭𒅆𒁺𒂗𒀀𒃻𒊑𒁺𒍜𒆪𒉡	STB
𒀀𒈾𒌓𒈬𒍝𒀀𒌓𒈾𒋗𒌑𒊩𒋙𒈠𒆷𒄩𒆷𒋙𒃮𒁉	LTB
𒋗𒁹𒀭𒄮𒀜	MPB
𒆬𒁉𒈬𒈾𒁕𒁀𒀊𒋧𒈬	SUX
𒅇𒊭𒋀𒅀𒀀𒈠𒀀𒋾𒋗𒆏𒁀𒊭𒁹𒈠𒉌𒂊𒅋𒅟𒀀	MPB
𒀭𒁲𒈨𒌍𒀭𒊭𒊩	SUX
𒌷𒆷𒆠𒀀𒈾𒄿𒁲𒉌𒅀𒄿𒅀𒉡	MPB
𒌑𒃻𒀜𒁀𒀊	NEA
𒀜𒈬𒌋𒆠𒄿𒉡𒀸𒅟𒌦𒈨𒌍𒃻𒀭	STB
𒊹𒊕𒀴𒋗𒄿𒈨𒌍	OLB
𒁺𒌑𒋗𒌓𒁺𒌑	STB
𒀴𒈨𒌍𒆠𒋾𒁹𒈗𒊑𒁁𒅀𒀭𒅀𒀭𒌓𒅀	MPB
𒀸𒅆𒈗𒂗𒀀	NEA
𒂖𒋾𒆪𒌑𒁹𒆷𒀊𒀀𒉿	MPB
𒀴𒈨𒌍𒃻𒈗𒉌𒄿𒉌𒇽𒀀𒆥𒈗𒆳𒉏𒈠𒆠	NEB
𒇽𒈾𒁷𒂍𒈬𒈨𒌍𒌋𒁕𒈪𒋻𒀸𒈬𒍮𒌑𒃻𒊹𒇽𒈾𒁷𒂍𒈬𒈨𒌍𒌋𒁕	LTB
𒀀𒈾𒅟𒋙𒉡𒋀𒈨𒌍𒆪𒉡𒌉𒈨𒌍𒆪𒉡𒀸𒋗𒊹𒂗𒁁𒈨𒌍𒆪𒉡	STB
𒅔𒌒𒄫𒈠	NEA
𒄷𒊑𒂊	STB
𒀭𒉺𒅇𒀭𒀫𒌓𒀀𒈾𒈗𒁁𒉌𒅀	NEA
𒅇𒊹𒂗𒄩𒀊𒁀𒌅𒃻𒈗𒀀𒆠𒇽𒉽	NEB
𒀀𒈾𒈬𒊒𒄣𒃻𒂍𒌋𒆠𒊒𒁀𒋙𒈬𒈨𒌍𒌉𒊩𒃻𒅇𒊹	LTB
𒅎𒆳𒊏𒁕𒆠𒊒𒁀𒀀𒃻𒌉𒃻	LTB
𒌑𒍝𒁉𒌅𒌋𒉌𒄿𒋢𒊑	NEA
𒉮𒆷𒁀𒉺	SUX
𒄑𒌆𒉿𒂼𒀀𒄰	SUX
𒈾𒌷𒂊𒉺𒁺𒀸𒌷𒊹𒁺𒌝𒈬𒄣	NEB
𒀀𒃻𒀀𒀀𒈾𒌋𒅗𒄭𒊹𒋗𒈫𒈨𒌍𒄩𒆷𒃻	LTB
𒊹𒈪𒋻𒌑𒊕𒆠𒆠𒋫𒅎𒆳𒊏𒁕𒋻𒁀𒊍𒃻𒁉𒈩𒌋𒊹𒋀𒋙	LTB
𒀭𒍍𒌑𒀸𒋰𒀭𒅎	SUX
𒁵𒄩𒉈𒍣𒍣	SUX
𒃻𒀫𒁕𒆠𒄿𒋼𒁲𒊑	NEB
𒊭𒂍𒀀𒁁𒂖𒉌𒉌𒌑𒇥	OLB
𒃻𒋗𒄿𒆪𒌦𒅗𒀹𒁯	OLB
𒅇𒅟𒀸𒁕𒋼𒅇𒂖𒆷𒀝	MPB
𒃻𒌷𒂍𒊹𒁕𒆪𒊒𒆬𒌓𒈠𒀪𒁺𒀸𒋗𒊹𒋙𒉡	NEB
𒈗𒇻𒊐𒁉𒅖𒄿𒈾𒂍	NEB
𒃻𒀀𒈾𒄑𒊒𒁀𒈬𒈨𒌍𒅅𒁉𒅆𒁺𒃻𒆠𒇽𒋀𒈨𒌍𒋙	LTB
𒄿𒁀𒀾𒅆𒌑𒊬𒄣𒌒	NEA
𒈾𒀜𒈾𒋾	MPB
𒉺𒌓𒀭𒀝𒀸𒈨𒊑𒌍𒋾𒉡𒄢𒈬𒌋	STB
𒁀𒊑𒂵𒑏𒑏𒑏𒑏	OLB
𒅅𒁍𒌋𒉌𒈠𒀀𒌋𒌋𒉡𒋗𒉡	NEA
𒀀𒈾𒆜𒄿𒋛𒅀𒆷𒀀𒅋𒌨	NEA
𒊩𒈠𒈠𒆷𒀀𒊬𒉺𒉌	NEB
𒃻𒀀𒀀𒁹𒋀𒀪𒌑𒌅	LTB
𒊭𒁁𒆷𒉡𒌝𒉺𒈥𒌅	OLB
𒄿𒊓𒌓𒈠𒀀𒁍𒂵𒉌𒋙	NEA
𒃻𒇽𒃵𒁍𒆷𒀀𒀀	NEB
𒑏𒑏𒑏𒑏𒑏𒍥𒁕	OLB
𒅆𒂟𒈨𒌍𒋼𒊭𒉽𒊭𒀀𒈠𒄯𒌋𒉌	NEA
𒊹𒌉𒊏𒌉𒌅𒌒𒆠𒅎	OLB
𒌷𒃻𒋛𒀀𒌅𒁉𒂊𒊒𒊹𒊹𒂆	NEB
𒍪𒀊𒉌	SUX
𒀭𒈗𒀖𒄵𒀭𒀫𒌓	SUX
𒋾𒅟𒀸𒊭𒀜𒀀𒁲	MPB
𒊹𒁕𒂍𒄩𒆷𒃻𒁹𒆷𒁀𒅆𒊹𒑛𒌑𒅎𒈥𒌅𒁕𒈨𒌍𒉺𒅆𒁴𒃻𒂍𒈬𒈨𒌍𒊹𒌑	LTB
𒌨𒆠𒉌𒂊𒋫𒅆𒈾	NEB
𒆕𒋾𒊏	SUX
𒀭𒊏𒄠𒈠𒀀𒉡𒌝	OLB
𒇽𒄥𒁍𒋾𒄿𒋾	NEA
𒈬𒊑𒅎𒀀𒉡𒌝𒈗𒂊	SUX
𒅴𒀀𒄭𒌈𒆳𒈥𒆠𒄿𒁁𒂖	STB
𒁀𒊑𒂵𒁀𒊑𒂵𒑏𒑏𒑏𒀀𒈾𒆠𒁉𒃻	OLB
𒊹𒂆𒈨𒌍	NEA
𒅇𒄿𒉡𒈠𒉿𒅅𒁉	MPB
𒅅𒅟𒀠	STB
𒈗𒋫𒄠𒄩𒊑𒀭𒊩𒌆𒊭	MPB
𒇽𒈨𒌍𒄤𒈨𒌍	MPB
𒀭𒀸𒉽𒄭𒄊𒋗𒊹𒄞𒁆𒀭𒉽𒌋𒌓𒆤𒃻𒊏𒆤	SUX
𒀲𒆳𒊏𒈨𒌍𒊭𒉺𒅁𒀀𒇻𒀀	NEA
𒋫𒆳𒄷𒁍𒊻𒆠𒀀	NEA
𒀀𒈾𒈪𒉌𒋾𒌍𒈬𒈾	MPB
𒅇𒀸𒌋𒅗𒆷𒉺𒋡𒁲𒅀𒀀𒈾𒈗𒂗𒅀	NEA
𒇽𒈾𒁷	LTB
𒀸𒌋𒅗𒌋𒌆𒆷𒉌𒊭𒈗𒁁𒇷𒉌	NEA
𒄑𒀀𒌅𒃮𒇺	STB
𒊹𒋙𒊹𒋙𒌦𒋡𒀀𒋾𒀾𒁍𒊩𒆚𒈠	NEB
𒀭𒁀𒌑𒂍𒄄𒀀𒉣𒆠𒂵	SUX
𒉌𒌨𒆪𒈨𒌍	NEB
𒊭𒂍𒂗𒈨𒌍𒅀𒀸𒆜𒉿	NEA
𒋫𒄩𒍝𒄿𒈾𒇽𒊓𒄤𒈨𒌍𒅇	MPB
𒉈𒈬𒊭𒇽𒌓𒌓𒀝𒆠𒀀𒀀	NEA
𒂍𒃲𒋾𒊏𒀾𒅟𒉌	SUX
𒈗𒌵𒆠𒊒𒋫𒇽𒉽𒋙𒃻𒀭	STB
𒀭𒍣𒆗𒆷𒁀𒈫	SUX
𒁀𒊒𒌑	MPB
𒀸𒋗𒊹𒋙𒉡𒀉𒋼𒄴𒅋𒋼𒈨𒋙𒉡𒌓	NEB
𒁹𒀳𒀭𒌓	OLB
𒁕𒀀𒇉𒀭𒈹𒊕𒆠𒀭𒋫𒅎𒈥𒌅𒁕𒊹𒈬𒍮𒌑𒃻𒁉𒈩𒋙𒉡	LTB
𒃻𒂍𒀭𒈨𒌍𒃻𒀕𒆠𒀸𒄷𒌓𒊮𒁉𒋙𒀸𒅖𒆠𒃻𒊩𒀭𒌈𒆕𒀜𒁮𒋙	LTB
𒌝𒈠𒈪𒉆𒈠𒁳𒁉𒀀𒂵𒀀𒆷𒀾𒈨	NEB
𒉌𒌓𒈩𒊹𒀭𒀸𒋩𒀸	NEA
𒇷𒁕𒅗𒈬	SUX
𒆏𒁉𒀀𒉿𒋼𒈨𒌍𒊭𒀾𒁓𒌋𒅗𒅆𒈾𒊬𒊒𒌝𒈠𒈗	MPB
𒈠𒀀𒄞𒀴𒈨𒌍	NEA
𒀀𒈾𒁇𒈨𒆠𒌑𒊺𒆗𒀭𒉌	NEB
𒀭𒂗𒆤𒀭𒊩𒌆𒅁𒅇𒀭𒉺𒌆	NEB
𒀜𒋫𒈗𒊒𒀭𒌓𒂗𒇷	MPB
𒀸𒀭𒌓𒌓𒁺	STB
𒊹𒀭𒇻𒅂𒀸𒅎𒋛𒁲𒁺𒄑	STB
𒁹𒀭𒉌𒉌𒊹𒇽𒀀𒋛𒀸	OLB
𒀀𒈾𒋾𒅅𒆠𒊭𒋀𒅀	MPB
𒇻𒌋𒄑𒍮𒊒	STB
𒉈𒅁𒄥𒊒	SUX
𒁀𒊑𒂵𒍥𒁕	OLB
𒂊𒁍𒍑	STB
𒀕𒆠𒌗𒋗𒌓𒊹𒈬𒊹𒁹𒀭𒋾𒀪𒄿𒆪𒋢𒈗	LTB
𒋛𒀀𒆠𒇴𒌷𒆠𒀀	SUX
𒌝𒈠𒁹𒄿𒇷𒊏𒁉𒄴	MPB
𒊹𒀉𒊩𒀀𒈾𒌉𒋙	NEB
𒌉𒃻𒊹𒀀𒊹	LTB
𒆠𒁉𒈠𒌝𒈠𒈗𒌝𒈠	NEB
𒊭𒀀𒍮𒁲𒄷𒌨𒍝	NEA
𒀀𒈾𒂼𒈗𒁁𒉌𒐊𒀠𒋰𒊏𒂗𒈾	NEB
𒁹𒀀𒉈𒀭𒈥𒌅𒋋	OLB
𒈗𒌌𒌑𒊺𒋾𒅅	NEB
𒊭𒀀𒈾𒇷𒁉𒀉𒀹𒁯	OLB
𒅎𒁾𒉿𒄩𒆷𒃻𒌉𒃻𒀀	LTB
𒀉𒋾𒀉𒁕𒀊𒁍𒌒𒈠	NEB
𒄑𒋛𒄷𒄿𒈾𒋫𒂇𒋾	NEB
𒆜𒊹𒀀𒈾𒄊𒊹𒋙	NEB
𒈗𒈨𒌍𒉽𒈨𒌍𒁲𒈬𒌇𒈨𒌍	STB
𒋗𒂊𒈠𒋾	SUX
𒁹𒈠𒋾𒇷𒅁𒇻𒌓	OLB
𒊹𒅇𒊹𒄠𒋻𒌓𒈠	MPB
𒌋𒊹𒋀𒋙	LTB
𒀝𒋼𒇷𒌝𒈠	NEB
𒀜𒋫𒋃𒊏	NEA
𒀀𒃶𒈾𒈗𒅖𒁓𒃮𒁉𒄿𒌓𒊒𒌑	NEB
𒈠𒀀𒊺𒉻𒈨𒌍	NEA
𒊏𒈬𒈠𒀀𒄿𒌅𒊒𒁺	NEA
𒌋𒌋𒈠𒈠𒆷𒀀𒈾𒊮𒁉𒅕𒊒𒁍𒆠𒁷𒌓𒋢𒅟𒊍𒋥	NEB
𒀀𒈾𒆪𒇻𒌑𒀜𒁷	MPB
𒅇𒀀𒈾𒉺𒉌𒀭	OLB
𒀸𒊮𒊹𒀲𒆳𒊏𒈨𒌍𒀀𒈾𒊹	NEA
𒀀𒈨𒌍𒊹𒊹	LTB
𒊭𒅖𒌅𒌷𒌑𒇡𒉺𒊏𒆠	OLB
𒁹𒆗𒈾𒀜𒂗	LTB
𒈗𒁁𒉌𒅀	NEA
𒁹𒄿𒄙𒀸𒁺𒉺𒊭	OLB
𒌅𒋚𒈠𒊍	STB
𒊹𒊹𒃻𒀸𒂍𒃲𒃻𒈗𒁁𒉌𒐊	NEB
𒈗𒈬𒁀𒍣𒄀	SUX
𒌉𒊩𒈨𒌍𒆪𒉡𒋫𒆳𒇷𒄴𒌨	STB
𒁹𒀭𒁕𒃶𒈠𒀭	OLB
𒌝𒈠𒁹𒁺𒍑𒋥𒋫𒈗𒃲	MPB
𒊑𒃻𒌈	MPB
𒌑𒉿𒊺𒊒𒈾𒅇𒍑𒊺𒊒𒅆	MPB
𒊹𒂗𒀲𒀸𒀸𒊮𒁉𒋙𒉡𒆷𒌑𒁉𒆷	NEA
𒅇𒋀𒅀𒆬𒄀𒈠𒀪𒋫𒊭𒆥𒆷𒅁𒊭𒇷𒊺𒂊𒁉𒆷𒅇𒀝𒋡𒀜	MPB
𒋗𒌨𒇯𒆬𒂵	SUX
𒊹𒇽𒋃𒌉𒃻𒀀𒀕𒆠𒌗𒁈	LTB
𒅇𒇻𒊺𒁉𒅋𒇽𒈨𒌍𒀀𒅀𒁉𒂊𒊭𒈗𒀀𒈾𒋗𒋾𒋗	MPB
𒊹𒊹𒄠𒆪𒌓𒀠𒇻𒈨	MPB
𒇷𒁲𒈪𒈗𒂗𒅀	MPB
𒈬𒈨𒌍𒌋𒋀𒈨𒌍𒋙𒌋𒇽𒂗𒄩𒆷𒈨𒌍𒋙𒃮𒁉𒀀𒈾𒊹𒂆𒆬𒌓	LTB
𒌋𒌑𒁲	SUX
𒈬𒉿𒋗𒃻	NEA
𒄠𒋻𒈪	MPB
𒂍𒅆𒂠𒊏𒋛𒀀𒂵	SUX
𒅇𒄩𒀜𒅀𒆪𒈠𒃲𒈠𒃲	MPB
𒃮𒁉𒀀𒈾𒇽𒉺𒇻𒌑𒌓𒀀𒈾𒊩𒂊𒋛𒀀𒌈𒊩𒌆𒋙𒉡𒌉𒊩𒃻𒊹𒁮𒃻	LTB
𒀀𒈾𒊹𒀭𒆳𒃲𒈬𒃻𒌦	NEB
𒁹𒀭𒌓𒈠𒉌𒉌	OLB
𒆜𒊹𒀴𒀭𒌓𒉺𒈥𒌅𒇽𒆠𒋩𒊏𒆠	OLB
𒋳𒈠𒀸𒋳𒈪𒅎𒈠𒁕𒊏𒄠𒂊𒁉𒅆𒀭𒈬𒌓𒋾	MPB
𒊹𒌋𒋀𒈨𒌍𒋙𒀀𒈨𒌍𒃻𒊹𒌌𒀉𒁷𒌋𒌌𒄿𒉆𒁷	LTB
𒈗𒀸𒆳𒀾𒁍𒀀𒈾𒃮𒊑	NEB
𒀭𒆪𒍝𒆳	SUX
𒊹𒊹𒅇𒊹𒋗𒋫𒌅𒌑𒈗𒆳𒊻𒉡𒂼𒀾	STB
𒅇𒄿𒊭𒆷𒇻𒅆𒅇𒄿𒈾𒉈𒈨𒌍	MPB
𒀴𒀭𒊏𒄠𒈠𒀀𒉡𒌝	OLB
𒀴𒅟𒊹𒀭𒀝𒄀𒀭𒊹𒀭𒌓	NEB
𒌓𒈨𒌍𒃻𒊹𒋗𒆷𒀀𒉌𒌈𒀀𒈾	NEB
𒇽𒀊𒄀	SUX
𒊭𒉿𒋡𒁍	MPB
𒀸𒌗𒉈𒂍𒁉𒌉𒈨𒌇𒅆	STB
𒊒𒈥𒌅𒆠	STB
𒀸𒀀𒆳𒀭𒂗𒇺𒅆	LTB
𒊹𒌋𒊹𒀀𒈾𒄊𒈨𒌍𒈗𒁁𒇷𒅀𒄠𒋻	MPB
𒆷𒄿𒀸𒅆	NEB
𒉌𒍝𒀊𒁁𒅇𒇽𒌉𒆥𒅁𒊑𒅀	MPB
𒅖𒁓𒀭𒈾𒅆𒉌	NEA
𒀀𒃻𒀀𒃻𒀀𒀀𒈾𒌓𒈬𒍝𒀀𒌓𒀉𒋫𒁷	LTB
𒁹𒂊𒊑𒁍𒉌𒌷𒆠	OLB
𒂗𒉣𒃻𒈗𒉌𒉆𒇡	NEB
𒀸𒉌𒁲𒀀𒉡𒋾𒋙	NEA
𒅔𒈾𒂇	STB
𒊭𒄿𒈾𒂍𒋛𒁲	OLB
𒀀𒈾𒊭𒀀𒋗𒈗𒆳𒈪𒋫𒈾	MPB
𒌨𒋢𒊹𒌨𒊓𒀀	NEA
𒊭𒈗𒆳𒉏𒈠𒆠	NEA
𒀀𒈾𒈗𒂗𒅀𒀖𒁲𒉡	NEA
𒀀𒁲𒊹𒋙𒁕𒀠𒄩𒀝	NEB
𒁾𒊬𒍠𒂵	OLB
𒅁𒉻𒋾𒅅𒈠𒄿𒈾𒉌𒄑𒅇𒍥𒁕	STB
𒁺𒄑𒊩𒊯𒈨𒌍𒍑𒈨𒌍	STB
𒌨𒈬𒌑𒌋𒁲𒈬𒀸𒆳𒅅𒅆	STB
𒈗𒂗𒅀𒅇𒇽𒈨𒌍𒃲𒁍𒋼𒈨𒌍	MPB
𒄊𒀭𒂗𒍪𒊺𒈪𒉺𒀀𒋛𒊑	OLB
𒌓𒄑𒍢𒁲	NEB
𒅅𒁉𒅆𒁺𒈪𒋻𒀸𒊹𒀸𒇻𒀴𒈨𒌍𒃻𒄭𒋫𒉻𒈨𒌍𒃻𒀀𒈾	LTB
𒁀𒊑𒂵𒑏𒑏𒑏𒑏𒍥𒁕	OLB
𒃻𒀕𒆠𒆗𒈬𒀭𒈾𒄖𒊌𒋡𒉌𒂊𒌓𒀊𒀊𒈨𒌍𒀸𒅎𒁾𒆠𒇴𒌋𒃮𒊒𒋙𒀀𒈾𒈦𒈠𒈾𒊹𒂆	LTB
𒀭𒊑𒂊𒉈	SUX
𒉠𒅆𒈬	SUX
𒀭𒀊𒌑𒋗	SUX
𒁕𒀊𒄭𒀊𒁕𒀊	MPB
𒊭𒄿𒈾𒂍𒀭𒅎𒈠𒀭	OLB
𒆳𒈲𒅟𒀀𒀀𒄑𒋛𒉌𒄑𒋛𒅆𒅅𒋾𒅀𒁲	NEA
𒌅𒊺𒆷𒈠	STB
𒉏𒈠𒋙𒁉	STB
𒅆𒄿𒆠𒄿𒈜𒁉𒊭𒋀𒅀𒅁𒊺𒀉𒅇	MPB
𒌓𒊹𒅇𒌓𒊹	LTB
𒊩𒅀𒀭𒋛𒀀𒌅𒊩𒆳𒃻𒊹𒁉𒊑	NEB
𒂊𒉺𒀾𒀸𒌷𒃻𒌑𒆥𒈬𒋫𒀀𒀀	NEA
𒇽𒀀𒆥𒅀𒀸𒌋𒅗𒊹𒀭𒅎𒀀𒀸𒀀𒉺𒅁𒊏	NEA
𒉺𒀀𒋛𒀸	OLB
𒋫𒀜𒁲𒈾	NEB
𒈗𒃻𒀀𒈾	NEB
𒈗𒆠𒊹𒊏	SUX
𒀭𒄑𒊺𒂠𒋗	SUX
𒊩𒆥𒅗𒂵	SUX
𒈲𒄈𒄯𒊕𒂷	SUX
𒀀𒀭𒉌𒅆𒊒𒁕𒂠	SUX
𒀀𒈾𒀴𒋗𒅇𒀀𒈾𒍝𒊏𒌷𒆠	MPB
𒁹𒀭𒌓𒈬𒉡	LTB
𒈹𒈨𒈬	SUX
𒁹𒅆𒈠𒀀𒄩𒋾	OLB
𒊹𒀸𒌓𒈨𒆷𒅕𒁉𒀀𒀭𒋩𒉣	STB
𒊬𒀸𒌑𒋼𒅕𒊏𒀸𒅆	OLB
𒌓𒈥𒊩𒈠𒉌𒌓	STB
𒊹𒀸𒌗𒂗𒉣𒅟𒊹𒁹	STB
𒀭𒊭𒄩𒀭𒀭𒈥𒌅	SUX
𒌝𒈠𒆷𒋫𒁄𒆷𒄩	NEB
𒌋𒌉𒈨𒌍𒃻𒀀𒈨𒌍𒃻	LTB
𒀸𒌓𒊹𒉽𒊹𒋗𒈫𒈨𒌍𒃻𒌓𒈬𒅇𒊹𒃻𒌓𒈬	LTB
𒀀𒈾𒁉𒄿𒌉𒈨𒌍𒀴𒀸𒊏𒋾	MPB
𒁹𒈠𒉿𒈠𒃲𒈠𒃲	MPB
𒀭𒉡𒌫𒀭𒌓𒀭𒉡𒌫𒀭𒌓	STB
𒄩𒀭𒁹𒊒𒆜𒋙𒉡𒌓	NEB
𒀭𒈹𒋢𒋾𒀉𒋢𒋾𒌅	SUX
𒊹𒌉𒃻𒊹𒌑𒍑𒆠𒌑𒅎𒍇𒇻𒁕𒂍𒌉𒃻	LTB
𒊭𒀊𒈝𒋋𒌓𒀕𒆠	OLB
𒌋𒅗𒄭𒅀𒆷𒀀𒄿𒈾𒀭𒁷𒉌	MPB
𒋢𒂔𒆠	STB
𒋛𒈨𒌍𒋙𒌓𒁺𒁕	STB
𒀀𒈾𒆪𒊹𒄿𒁀𒊭𒋾	MPB
𒊹𒄩𒀭𒍪	LTB
𒀭𒈫𒁲𒋻𒋗	SUX
𒀸𒌷𒈪𒉡𒀪	NEA
𒀸𒅕𒋾𒉌𒈾𒀀𒍝	NEA
𒌷𒀭𒃻𒈦𒉽𒅕	NEA
𒌉𒊩𒃻𒌉𒋙𒁮𒌉𒃻	LTB
𒅇𒂟𒈨𒌍𒋢𒄴𒄭𒉘𒈠	NEB
𒊹𒀭𒊕𒈨𒃻𒀸𒆜𒋗𒌓𒀭𒀀𒉏𒅆	STB
𒊩𒈨𒆜𒆷𒅟𒉌	SUX
𒊭𒈬𒈾𒉿𒀸𒉺𒋼𒋛𒇽𒀊𒉣𒈾𒆠	OLB
𒀸𒈬𒊺𒍝𒉌𒂊𒂗𒆤𒆠	NEB
𒇽𒁾𒊬𒇽𒄬𒊭𒀭𒈨𒌍	MPB
𒆠𒇴𒅎𒄿𒉚𒌋𒈨𒌍𒅇𒊹𒂆	LTB
𒊹𒊩𒊕𒀸𒊹𒌉	OLB
𒅆𒂟𒈨𒌍𒆷𒄯	NEA
𒀸𒉺𒉌𒉌𒄿𒋾𒋾𒋢	NEA
𒊹𒊹𒀸𒆳𒋙𒊺𒅕𒍣𒋛𒀀𒅍𒀭𒈪𒃻𒈠	STB
𒅇𒆷𒀀𒄩𒋫𒆪𒅇	MPB
𒂍𒇉𒊏𒅗𒈝𒈠	SUX
𒋀𒀀𒈾𒌓𒈬𒍝𒀀𒌓𒋗𒌑	LTB
𒀀𒈾𒁹𒀭𒌓𒈬𒉡𒀀𒈾𒌓𒈬𒍝𒀀𒌓𒄿𒉆𒁷𒁍𒌑𒌓	LTB
𒌷𒈨𒌍𒉌𒀭𒉡𒋾	NEA
𒇽𒂗𒉆𒃻𒌷𒂍𒍝𒄠𒈠𒉡	NEB
𒀊𒊮𒆳𒄭𒀊𒄩𒀀𒉏𒈠𒆠𒌋𒌦𒈨𒌍𒋙𒌑𒋼𒁺𒌑	STB
𒂙𒆳𒋛𒁲𒆳𒃶𒉣𒅎𒈥	STB
𒅇𒋾𒁄𒆠𒌅𒇽𒈨𒌍𒅆𒅇𒀀𒄯𒈪	MPB
𒊹𒀭𒇻𒅂𒀀𒈾𒀯	STB
𒁀𒊑𒂵𒑏𒑏𒑏𒍥𒁕	OLB
𒂍𒌋𒌆𒁀𒉌𒈨𒌍𒋙𒌋𒂍𒊿𒁍𒈨𒌍𒋙𒂍𒈩𒋾𒋙𒉡𒀸𒂍𒀊𒃲𒀸𒁉𒈩𒄑𒊬𒈨𒌍	LTB
𒀀𒊑𒅅𒋫𒁀𒀀	NEB
𒋡𒀠𒇻𒇻	MPB
𒀭𒊩𒌆𒄬𒋗	SUX
𒃻𒂍𒈬𒈨𒌍𒋗𒆸𒆸𒍑𒈨𒌍𒌋𒊕𒆠𒈪𒋚𒌈𒂍𒋗𒈫𒈬𒈨𒌍	LTB
𒊭𒄿𒈾𒆍𒃲𒀭𒈗𒄊𒊏	OLB
𒃮𒊑𒆳𒀸𒋩𒆠𒌋𒆳𒌵𒆠	STB
𒉺𒉌𒈗𒁁𒉌𒅀𒀜𒁕𒃲	NEB
𒉺𒀀𒋛𒊑	OLB
𒈗𒁁𒉌𒌑𒁕𒀀𒆠𒄿	NEA
𒌗𒇯𒆬	SUX
𒇽𒊏𒃻𒉌𒃻𒆳𒆗𒁺	NEB
𒈠𒀀𒁕𒆠𒄿𒄿	NEB
𒊹𒌑𒈥𒊩𒈠𒀀𒈾𒊹𒌉𒃻𒁹𒀭	LTB
𒌒𒁍𒌅𒀸𒆳𒌵𒆠	STB
𒌋𒀭𒇡𒉺𒉌𒌈	MPB
𒆷𒁳𒁉𒀉𒋾𒋙𒀉𒁳𒁍	NEB
𒌋𒌆𒁀𒉌𒋙𒌋𒂍𒄩𒉡𒌓𒌓𒅁𒋙𒃻𒂵𒊹𒃻𒀸𒊹𒀀𒇉𒂟𒋼𒉡	LTB
𒂗𒅀𒀠𒋰𒆜𒋙	NEB
𒁹𒄿𒍝𒌈	OLB
𒂗𒈾𒈗	NEB
𒊹𒀀𒄭𒅀𒃼𒅇𒀴𒈨𒌍𒃻𒀭𒃽𒃻𒀀𒃰𒆠	NEB
𒀭𒊌𒈤𒀭𒁲𒋻	SUX
𒁹𒆷𒁀𒅆𒊹𒌉𒃻𒁹𒀭𒈾𒈾𒀀𒈬𒀀𒁹	LTB
𒈗𒊑𒊭𒆠𒈠𒀭𒅎	MPB
𒀭𒊩𒌆𒄯𒆠𒁮𒀭𒊩𒌆𒉾𒆤	SUX
𒀀𒈾𒈗𒀀𒉺𒅁𒉺𒉘𒈠𒊩𒈬𒌑	NEB
𒄩𒍣𒋡𒌈𒉺𒊍𒅟𒀸𒄭𒋛𒀸	STB
𒄑𒄖𒍝𒌑𒋦𒊹𒀸𒋩	NEA
𒌌𒀀𒈾𒂗𒆤𒆠𒅋𒇷𒅟𒀀	NEB
𒀀𒈾𒀀𒈠𒀀𒊑𒉺𒉌𒈗𒂗𒅀	MPB
𒁀𒀭𒄭	SUX
𒄈𒊑𒊭𒈗𒂗𒐊	NEA
𒀀𒀊𒁀𒅆𒉏𒅟	SUX
𒃻𒅎𒂂	STB
𒈗𒄿𒌑𒈨	NEA
𒀭𒀀𒌉𒂼𒋠𒇲𒆤	SUX
𒇽𒉌𒋛𒅔𒆠	OLB
𒁾𒁍𒈠𒁺𒋾	NEA
𒀭𒈨𒌍𒁹𒆳	STB
𒀭𒊊𒈨𒈨𒀭𒅎	SUX
𒀭𒆷𒂵𒈠𒀠𒀭𒊊𒀕𒃲	SUX
𒀀𒈾𒉺𒉌𒀭	OLB
𒀀𒈾𒀭𒂗𒍪𒊺𒈪	OLB
𒋾𒉌𒅁𒋗𒅟𒇷	MPB
𒅇𒅖𒌅𒇽𒀴𒋗	MPB
𒋙𒅎𒂂	STB
𒁹𒀯𒋗𒉺𒋼	STB
𒇽𒈬𒁺𒁹𒀭𒌉𒃻𒊹𒀀𒊹	LTB
𒆪𒍪𒌌𒈝	MPB
𒀸𒋾𒈠𒇷𒊩𒅆𒌓𒈨𒆠𒄿𒊹	NEA
𒊑𒈪𒉡𒌑𒀭𒀫𒌓	STB
𒊹𒌉𒊏𒋫𒊑𒁀𒌈	OLB
𒉆𒄩𒅈𒋾𒀀𒄯𒄿𒇻𒌓𒀭𒂗𒍪𒉺𒋼𒋛	OLB
𒀀𒈾𒍢𒊑𒂊	NEB
𒋫𒋫𒄩𒊍𒅇𒇽𒂇	NEA
𒅇𒌷𒄠𒁉𒅇𒆷𒋡𒈠	MPB
𒁹𒀀𒋾𒂊𒉡𒁺𒌨𒋢	LTB
𒆷𒌑𒋻𒇺𒃻𒄑𒋙𒀀𒈾𒌗𒋙	STB
𒅆𒈾𒌆𒉈𒋛	SUX
𒈠𒀀𒄑𒉺	NEA
𒀀𒈾𒈠𒋡𒋾𒌋𒅗𒅀𒈪𒈾	MPB
𒃻𒋗𒈛𒄩𒄊𒈨𒌍𒌓𒅗𒁇	MPB
𒊹𒀸𒆳𒅎𒂂𒊓𒋛𒀀	STB
𒅇𒋾𒀭𒆠𒌷𒍮𒈬𒊑𒅇	MPB
𒈠𒀀𒀀𒈾𒊹𒉺𒊏𒈬	NEA
𒂵𒋾𒂊𒆠𒉘	SUX
𒋗𒌑𒈠𒀀𒀀𒈾𒌋𒅗𒊹𒀴𒀭𒊩𒌆𒆤	NEB
𒀭𒈹𒀀𒅆𒁁𒇹𒀭𒆠𒄿𒆳𒋫𒄩𒍝𒀀𒋾	STB
𒈬𒈨𒌍𒄑𒊒𒁀𒇽𒄈𒇲𒌑𒌓𒈬𒈨𒌍𒃻𒌉𒃻	LTB
𒇽𒈨𒌍𒈠𒍝𒊏𒌓𒀉𒋾𒅀𒅇𒀸𒁍𒌨	MPB
𒊹𒑛𒂆𒊹𒊺𒆬𒌓	OLB
𒀸𒆳𒌵𒆠𒅅𒈨𒌍	STB
𒁾𒉿𒊹𒀸𒋩𒉽𒀸𒌋𒌋𒆳𒀸𒋩𒆠	NEA
𒅇𒇷𒅁𒁍𒋗𒉏𒆏𒁉	MPB
𒆷𒀠𒇷𒆠	NEA
𒂍𒆠𒊒𒁀𒀪𒈨𒌍𒈬𒈨𒌍𒅇𒄑𒊒𒁀𒈬𒈨𒌍𒃻𒆠𒌋𒁹𒀭𒈾𒈾𒀀𒈬	LTB
𒌉𒃻𒇽𒌆𒌓𒀸𒄷𒌓𒊮𒁉𒋙𒂍𒋢𒅁𒋙𒂍𒈩𒋙	LTB
𒆳𒄩𒊒𒁉𒂊𒅥	STB
𒆠𒁉𒃻𒊏𒁉𒂠	SUX
𒑏𒊺𒊹	SUX
𒀀𒈾𒁕𒂵𒇷𒈠𒀀𒈾𒀀𒁉𒅟	MPB
𒀀𒇉𒆠𒋩𒊏𒄰	SUX
𒁹𒋫𒀜𒁲𒅔𒊓	OLB
𒀭𒁺𒈝	SUX
𒇽𒋃𒀀𒃻𒀀	LTB
𒍑𒄭𒄭𒅔	MPB
𒊭𒅖𒌅𒂍𒊩𒍑𒁇	OLB
𒀉𒊑𒆪𒌷𒄵𒌅	NEA
𒌨𒁉𒅔𒅆𒊒𒉈𒌍	SUX
𒊹𒂗𒇽𒊕𒈨𒌍𒇻𒍢𒀀	NEA
𒄿𒈾𒀭𒈾𒂗𒉌𒅁𒊭𒀜	MPB
𒍮𒁓𒊩𒄩𒀭𒈾𒀀	LTB
𒄖𒁉𒅔𒆠	SUX
𒊭𒊕𒇻𒌑𒉌𒀸𒁈𒉺𒇻𒆠	NEA
𒊮𒊭𒀠𒆷𒀜𒀭𒁕𒃶𒈠𒀭𒌑𒊭𒊑𒀀𒄠𒆜𒊹	OLB
𒌉𒌋𒌋𒂗𒅀	NEA
𒌑𒈠𒀀𒆠𒄿𒊹𒊑𒋫𒀀𒈪𒌅𒌋𒉌	NEA
𒀀𒃻𒁹𒁀𒆷𒂅𒄑𒊒𒁀𒇽𒆭𒂍𒌑𒌓𒈬𒈨𒌍𒀀𒈾𒆬𒌓𒀀𒈾𒊑𒄷𒄭𒌈	LTB
𒊭𒄑𒇷𒀪	NEA
𒀀𒈾𒇽𒈨𒌍𒄩𒍝𒉡𒌑𒋾𒆠𒄿𒋼𒂊𒈪𒄿𒅟	MPB
𒃻𒂍𒇽𒄘𒂗𒈾𒃻𒈗𒁁𒉌	NEB
𒃻𒌝𒈠𒀀𒆳𒈗	NEB
𒊹𒊹𒊹𒊹𒊹𒃷𒀀𒊮𒊹	SUX
𒊹𒊕𒀴𒈨𒌍𒊑𒁺𒁴	OLB
𒈠𒀀𒋾𒄿𒁉𒂖	STB
𒅆𒊹𒆪𒆷𒀀𒀀𒇽	NEA
𒁹𒇽𒁹𒂗𒍪𒈾	SUX
𒌉𒃻𒊹𒌋𒈪𒋻𒌑𒊕𒆠𒆠𒋫𒅎𒆳𒊏𒁕𒈬𒍮𒌑𒃻𒁉𒈩𒋙𒉡𒊒𒄖𒁍	LTB
𒆳𒌒𒁍𒌅𒁺𒀝	STB
𒊭𒀭𒈨𒌍𒌷𒂊𒈥	MPB
𒌅𒂷𒆷𒃻	STB
𒇽𒅗𒈠𒁉𒈨𒌍	SUX
𒇽𒊕𒈨𒌍𒊭	NEA
𒌋𒌆𒇻𒃻𒈗	NEB
𒆳𒋫𒈬𒈾𒋫𒇯𒁺	SUX
𒌑𒊏𒀀𒀀𒇽𒈬𒆸𒋢𒉺𒈨𒌍𒅀	NEA
𒄿𒈾𒄊𒊹𒈨𒅀𒆠𒄿	NEB
𒌉𒊩𒃻	LTB
𒌅𒄬𒋃	STB
𒊺𒁉𒆷𒌝𒈠𒁹𒆪	NEB
𒃻𒅟𒆳	NEB
𒊭𒀀𒈾𒀭𒈥𒌅𒈾𒍢𒅕	OLB
𒀭𒂊𒉈𒆤	SUX
𒌋𒌉𒈨𒌍𒃻𒀀𒀸𒄷𒌓𒊮𒁉𒋙𒉡𒆠𒊒𒁀𒀀	LTB
𒅇𒀀𒈾𒋀𒅀𒌑𒌒𒁀𒇻𒀭𒌋𒁯𒁁𒂖𒋾𒁁𒇷𒀉𒆳𒆳𒅇	MPB
𒌑𒉋𒆠𒋛𒀉𒌈𒋾𒌑𒋢𒉺𒇻	STB
𒌉𒊩𒃻𒀸𒄷𒌓𒊮𒁉𒋙	LTB
𒌓𒈬𒁍𒁕𒈨𒌍𒈬𒀭𒈾𒈨𒌍	NEA
𒌀𒈨𒌍𒀀𒈾𒀀𒃻𒀀𒈾𒌓𒈬𒍝𒀀𒌓	LTB
𒀀𒈾𒅀𒀀𒅆𒅇𒀀𒉡𒌑𒄿𒋾𒀭𒆷	MPB
𒂗𒅀𒄿𒈾𒋡𒋾𒅀	MPB
𒅇𒊹𒂗𒋙𒈜𒇷𒆚𒈠	NEB
𒅆𒊹𒀭𒉺𒅆𒂟	NEA
𒈬𒈨𒌍𒌉𒃻𒊹𒌉𒋙	LTB
𒀭𒆜𒅋𒄩𒆳	SUX
𒀸𒆠𒋫𒆪𒌑𒊑𒋫𒊬𒊐𒀸𒁍𒋾	STB
𒌀𒈨𒌍𒀀𒈾𒀀𒃻𒀀𒃻𒀀𒀀𒈾𒌓𒈬𒍝𒀀𒌓𒋺𒋫𒁷	LTB
𒌓𒉣𒆠𒅔𒀝𒀀	SUX
𒅇𒇷𒂖𒈠𒀜	MPB
𒊭𒀭𒌓𒈬𒅆𒍣𒅁	OLB
𒌗𒉈𒌓𒊹𒈬𒆚𒁹𒋛𒇻𒆪𒈗	LTB
𒀸𒉈𒍑𒁲𒀸𒀊𒉿𒈬𒌁𒊑𒋫𒅆𒈠𒄠𒈠	STB
𒀭𒂗𒍪𒂵𒅖	OLB
𒀀𒈾𒇽𒃻𒌆𒀜𒋙	NEB
𒂦𒌷𒆬𒂵	SUX
𒈲𒁉𒈲𒈤𒈬𒉌𒈲𒀭	STB
𒈽𒌉𒌉𒈬	SUX
𒊹𒈨𒇽𒄿𒌅𒀀𒀀𒄿𒋛𒋙	NEA
𒊹𒊕𒊩𒆳𒈨𒌍𒀀𒈾𒄸𒁍𒈨𒌍	OLB
𒀭𒋛𒂍𒋼𒀭𒈨𒌍𒃼𒁺𒋼𒀸𒄑𒆪𒈨𒌍𒋙𒉡𒄑𒍪𒋾𒈾𒀾𒉼𒋫𒆪𒉡𒇺𒆲	STB
𒌉𒅕𒍢𒅀	OLB
𒀖𒁍𒁍𒈠	NEB
𒊺𒅔𒉡𒈨𒌍𒄠𒈥𒊭	NEA
𒌉𒆷𒉌	SUX
𒄿𒉡𒈠𒄿𒈬𒋫𒀀𒈾𒆪𒊭𒉌𒌓	MPB
𒊹𒉌𒃮𒀭𒈤𒆤	SUX
𒃻𒀜𒁕𒃰	NEB
𒌋𒌋𒌋𒄥𒊺𒊹	SUX
𒀚𒄑𒌆𒉿𒈬	SUX
𒉆𒌀𒈨𒌍𒌓𒊹𒆚𒅅𒈨𒌍𒈗𒈥𒌅𒆠	STB
𒁺𒌦𒄣𒆳𒄿𒄬𒌨	STB
𒀀𒆠𒄭𒂅𒃻𒀀𒈾𒈗𒂗𒐊𒄴𒂅𒌑	NEB
𒁉𒊒𒌈𒄩𒈪𒄷𒍝𒁉𒄩𒈪𒌑𒄷𒍝𒁉𒃻𒊩𒈠𒆷𒋗𒀀𒌈	STB
𒀀𒃻𒃻𒂊𒌑𒉺𒉺𒄭𒊕𒆠𒀭𒋫𒅎𒈥𒌅𒁕𒄑𒊬𒃻𒀊𒃲	LTB
𒋢𒊓𒋛	SUX
𒋾𒌅𒊻𒆪𒌑	STB
𒀸𒍮𒌝𒈨𒂊𒆷𒋗𒊹𒈗	NEB
𒊭𒉌𒌓𒈪𒅀𒈪𒋗𒉡𒌉𒈨𒌍	MPB
𒈨𒌍𒁀𒆳𒂅𒀸𒌋𒅗	NEA
𒌝𒈠𒁹𒀭𒅎𒈪𒄭𒅕	MPB
𒅇𒀀𒈬𒌨𒈪𒌷𒌷𒆠𒆠𒋾	MPB
𒌓𒅘𒁍	SUX
𒌷𒄭𒀀𒉌𒅇	MPB
𒀀𒊮𒃮𒁲	NEA
𒀀𒈾𒀀𒈠𒊑𒉺𒉌𒂟𒂗𒅀	MPB
𒂊𒍢𒁲𒋢𒉡	NEA
𒂊𒊑𒁀𒄠	OLB
𒊹𒊹𒀸𒉣𒇬𒊹𒁺𒀸𒆳𒆤𒌓𒅅	STB
𒆤𒋾𒅅𒅆	STB
𒌓𒈬𒀸𒌓𒊹𒅇𒈪𒋻𒀸𒌓𒊹𒄑𒊒𒁀𒋙𒃻𒌓𒈬	LTB
𒁹𒉌𒉌𒂗𒉆	SUX
𒊾𒁇𒌓𒅗𒁇	SUX
𒉡𒆠𒄿𒐊	NEB
𒀀𒈾𒂍𒊩𒍑𒁇𒈨𒌍	OLB
𒊹𒀀𒁹𒂍𒆳𒍝𒄫	LTB
𒅎𒁹𒀭𒀝𒆐𒇽𒂗𒌋𒌋𒁲	LTB
𒋃𒀭𒊏𒈠𒉡𒌝	OLB
𒅇𒅔𒈾𒁉𒀉𒈪𒀀𒈾𒇽𒊓𒄤𒈨𒌍	MPB
𒈗𒆬𒍪	SUX
𒈠𒄭𒄑𒀀𒆗𒌋𒌋𒁕𒅀𒆥𒈬	NEA
𒀀𒈾𒍝𒁴	OLB
𒁹𒀭𒇽𒊷	SUX
𒅖𒋾𒈨𒊭𒉺𒅈	MPB
𒉆𒄩𒅈𒋾𒁹𒈬𒋾𒀭𒁕𒃶	OLB
𒀭𒍣𒊺𒁔𒀭𒁲𒋻	SUX
𒇽𒉺𒄭𒍪	NEA
𒆕𒋡𒊒𒅇𒈨𒂊𒄿𒁀𒀾𒅆	NEB
𒀀𒈾𒊩𒊮𒄞𒈨𒌍	OLB
𒁹𒀭𒀫𒌓𒄩𒍣𒅕	OLB
𒆷𒆠𒀀𒈨𒌍𒀀𒈾𒅆𒋾	MPB
𒁹𒀭𒈾𒈾𒀀𒈬𒋀𒈨𒌍𒋙𒉡𒌉𒈨𒌍𒃻𒌉𒃻𒀀𒀸𒂍𒈨𒌍𒅇	LTB
𒁹𒀀𒈾𒀭𒂗𒍪𒁖𒆷𒆪	OLB
𒊭𒁉𒅕𒌷𒂦𒀭𒈾𒆠𒌒𒇴	OLB
𒀖𒁍𒁍𒈗	NEA
𒅇𒋼𒉌𒁍𒋗𒈾𒀀𒈾𒁹𒀀𒍣𒊑	MPB
𒁹𒂊𒊑𒁀𒄠𒀭𒂗𒍪	OLB
𒄿𒈥𒊒𒊻	STB
𒀊𒄩𒀀𒀀	SUX
𒊹𒀸𒌗𒂗𒉣𒅟𒅎	STB
𒋗𒌑𒊭𒄿𒊏𒀪𒀀𒈬𒅇𒀀𒈾𒀾𒋗𒀭𒈾𒀀𒋾𒌑𒌌𒄿𒈾𒀭𒁷𒈨	MPB
𒌌𒄫𒁉𒅟𒌦𒄣	NEB
𒀭𒂊𒌋𒆠𒁴𒀀𒈾𒁷𒍣𒈨𒌍	NEB
𒀲𒌑𒁺𒇷	SUX
𒊹𒄑𒈠𒄭𒊑𒊕𒉡	NEA
𒈗𒁁𒅋𒅟𒀀𒈾𒈤𒊑𒅟	MPB
𒈗𒉏𒈠𒆠𒀸𒄑𒆪𒊒𒌓	STB
𒊹𒉽𒁀𒉡𒌑𒌓𒀀𒈾𒉚𒌀𒈨𒌍𒀀𒈾𒌉𒃻𒀀𒃻𒀀𒃻	LTB
𒌑𒂙𒌷	NEB
𒊭𒈬𒅎𒈠𒀸𒌋𒅗𒄭𒋙𒉡	NEA
𒀸𒄑𒈪𒃻𒂗𒈗𒈨𒌍	NEB
𒌗𒊺𒆥𒋻𒌓𒄰	OLB
𒅖𒁓𒀭𒉌𒆠𒄿𒀭𒉌𒈠	NEA
𒄿𒁲𒁁𒇷𒋳𒈠𒋫𒊒𒄿𒈾𒌓𒆚	MPB
𒁁𒉌𒐊𒀀𒈾𒌓𒈨𒍝𒀀𒋾𒌨𒁍𒌑	NEB
𒁀𒀪𒌑𒀀𒆷𒆪	STB
𒀀𒈾𒁹𒈗𒊑𒁁𒅀𒀭𒅀𒀭𒌓𒅀	MPB
𒌗𒆥𒀭𒈹𒌓𒊹	OLB
𒅆𒋾𒆠𒅋𒈬	SUX
𒊭𒀀𒇉𒉺𒀀𒋾𒀭𒁁	NEA
𒌉𒈬𒉡𒈨𒂗	SUX
𒁹𒉌𒉌𒀀𒉿𒅆𒊏𒁉	OLB
𒉌𒌓𒈩𒃮𒅆𒀀	SUX
𒀭𒊩𒌆𒊹	SUX
𒀀𒈾𒀀𒃻𒀀𒈾𒌓𒈬𒍝𒀀𒌓𒈾𒋗𒌑𒅆𒅖𒋙𒅇	LTB
𒄩𒉌𒆥	NEA
𒌌𒄿𒌋𒌋𒄥𒌝𒈠𒀀𒈾𒀀𒁲𒂊𒌌𒀀𒋻𒇻	NEB
𒆬𒌓𒋡𒇻𒌑𒊹𒌉𒃻	LTB
𒊹𒇽𒋃𒇽𒍑𒆪𒈤𒊹𒌉𒃻𒀀	LTB
𒂍𒀭𒃲𒁴𒍪𒀊𒅟𒂠	SUX
𒂊𒅁𒁍𒊭𒄿𒆏𒁉𒀀𒈠𒁕𒄑𒍝𒃼𒌨𒊕𒅀𒆳𒂵	STB
𒌉𒊩𒊩𒆳𒀭𒂗𒍪	OLB
𒋗𒁀𒀭𒍣𒍣𒀀	SUX
𒂍𒁴𒃲𒀭𒈾	SUX
𒂆𒆬𒌓𒀀𒈾𒊹𒄿𒉆𒁷𒌋𒆠𒄿𒊹𒀀𒂵𒀀	LTB
𒀀𒈾𒊹𒂗𒀜𒉽	NEA
𒀀𒌉𒃻𒀀𒃻𒀀	LTB
𒊹𒀭𒂗𒌑	NEB
𒅇𒉿𒁷𒈗𒂟𒈨𒌍𒅇	MPB
𒈬𒁉𒌝	MPB
𒁹𒅖𒆠𒇷𒅇	MPB
𒅇𒆳𒆷𒋗𒊹𒈗	NEB
𒊭𒀸𒅆𒅟𒈠𒀀𒄭𒍢𒅔	NEA
𒄭𒂅𒊭𒀭𒈨𒌍	NEA
𒌌𒄿𒍣𒄑𒍝𒀀𒈾𒊮𒁉𒃻𒄭𒀀𒀀𒀉𒋫𒊬𒊏𒅇	NEB
𒊹𒉡𒊑𒅀𒇽𒃲𒆠𒈲𒅇𒊹𒀸𒋩𒋀𒅕𒇽𒃲𒊕𒈨𒌍	NEB
𒇻𒁀𒊑𒃻𒇻𒌑𒌨𒈤	STB
𒃻𒉺𒊏𒄊	STB
𒂍𒀭𒈗𒌾𒆠𒅟𒆤	SUX
𒆳𒆷𒋗𒊹𒈗𒌑𒋻𒇻𒌑𒊹	NEB
𒂗𒅅𒁍𒌑𒉌𒈠𒀭𒉌	NEA
𒄿𒋢𒄴𒊒𒋫𒋀𒈨𒌍𒋙𒇽	NEA
𒀭𒂗𒉡	SUX
𒊹𒌉𒀭𒂗𒍪𒀀𒊭𒊑𒀉	OLB
𒅇𒇷𒅋𒈠𒀜	MPB
𒀭𒌓𒀕𒆠𒅆𒊒𒁕𒋗	SUX
𒌅𒋚𒅘	STB
𒀸𒄷𒌓𒊮𒁉𒋙𒊹𒄑𒊒𒁀𒋙𒇽𒆭𒂍𒀜𒄬𒌑𒌓𒌋𒇽𒆬𒁴𒌑𒌓	LTB
𒌗𒁈𒍠𒃻𒌓𒊹	OLB
𒋛𒆗𒅆𒄿𒈾	NEB
𒌅𒆷𒀪𒀾	STB
𒊭𒈠𒁕𒋼𒊭𒈗𒂗	NEA
𒋡𒆷𒋫𒅇𒌅𒌌𒆠	MPB
𒂦𒉡𒊌𒆪𒋢𒇽𒃲𒅟𒈲	NEB
𒉿𒁺𒈗𒈠𒉌𒌓𒆚𒈨𒌍	MPB
𒋫𒊮𒋼𒀀𒈨𒀀𒄩𒅖𒉌	NEA
𒄿𒈾𒀾𒅆𒋗𒈗	NEA
𒇽𒌷𒈾𒍝𒀸𒆠	OLB
𒋗𒁹𒍪𒁀𒆷𒌉𒀭𒅎𒈠𒌨	MPB
𒀭𒉌𒅅𒄭𒁉𒀀𒈠𒀀	NEA
𒉆𒄩𒅈𒋾𒁹𒄿𒁲	OLB
𒀲𒆳𒊏𒈨𒌍𒀀𒈾𒊹𒂗𒄑𒀀𒋼𒁷	NEA
𒀭𒈾𒁉𒌝𒈛𒀭𒀫𒌓𒆤	SUX
𒀀𒁹𒂍𒆳𒍝𒄫𒀀𒈾𒌓𒈬𒍝𒀀𒌓𒋙𒉡𒁍𒌋𒌓𒀀𒄩𒀀𒈩𒀀𒈾𒄯𒊒𒄣𒈾𒃻𒀪	LTB
𒊭𒁓𒀭𒂗𒍪	OLB
𒌓𒊹𒌓𒊹𒌓𒊹𒅇𒌓𒊹	LTB
𒀀𒄥𒊑𒋫𒈾	STB
𒅖𒁍𒊒𒉌𒄿𒈾𒄊𒊹	NEB
𒀭𒌨𒁀𒌈𒁮𒁉𒊩	SUX
𒌗𒈫𒄰𒈠𒂠	SUX
𒇽𒈬𒊬𒆧	NEA
𒅇𒆠𒄿𒄿𒋡𒁍𒈗𒀀𒈾𒈪𒉏𒅖𒋰𒊒	MPB
𒈜𒇷𒆚𒈠𒀀𒈾𒈗	NEB
𒀀𒈾𒁁𒂊𒂖𒋾𒋗𒁁𒂊𒂖𒋾𒄿𒇻𒊭𒄿𒈾𒅈𒄩𒀀𒉌	STB
𒀀𒈾𒅆𒃮𒀀𒋙	STB
𒉽𒁀𒉌𒋾𒀀𒈾𒉺𒀭𒀜𒊑𒅟	NEB
𒉡𒋛𒁲𒆠𒈫𒆳𒈥𒌅𒆠𒌉𒅕	STB
𒀸𒄑𒈪𒃻𒈗𒆳𒆳𒁁𒉌𒅀	NEB
𒈨𒅁𒅎𒍣𒂵	OLB
𒀀𒈾𒀭𒌓𒈬𒁀𒉌𒀉	OLB
𒁹𒀀𒈠𒀭𒄩𒀜𒁉𒇽𒌷𒌅𒋗𒌌𒋾𒆠	MPB
𒃻𒂍𒋙𒀉𒌨𒋙𒋡𒉡𒌑𒌋𒄑𒃡𒀸𒊮𒁉𒄿𒁳𒁁𒀀𒈾	LTB
𒋞𒈨𒌍𒋼𒀀𒆳	NEA
𒊭𒀸𒅆𒂊𒅟𒉌	NEA
𒇻𒌋𒊹𒅇𒌉𒈨𒌍𒋙	NEA
𒈾𒃰𒈪𒉌𒂍	OLB
𒌅𒋻𒉺𒅁	STB
𒉚𒂍𒋙𒈬𒈨𒌍𒌀𒈨𒌍𒀀𒈾𒌉𒃻𒀀	LTB
𒇽𒃲𒅇	MPB
𒈗𒆳𒉽𒋙𒆳𒄉𒆳𒅆𒌨𒃻𒋺𒋛𒈠𒅆𒂟𒅆𒈥	STB
𒃻𒊹𒁮𒁹𒀭	LTB
𒄩𒀀𒁍𒅆𒈨𒊑𒋙𒌋𒅗𒈝𒈠𒉡𒋛𒁲	STB
𒁹𒀀𒁲𒀭𒉌𒀀𒇽	OLB
𒇽𒀀𒆥𒋫𒆳𒌓𒋢𒀀	NEA
𒅇𒆷𒀀𒋾𒍣𒍝	MPB
𒌑𒊓𒉌𒄣𒉌	NEA
𒃻𒂅𒌒𒊮𒁉𒈬𒀭𒈾𒈨𒌍	NEB
𒄿𒇷𒀪𒌑𒀀𒈾𒇽	NEB
𒃻𒌌𒉺𒉈𒌓𒁺	SUX
𒀲𒃵𒂷𒈨𒌍𒄠𒈥	NEA
𒊹𒅆𒅕	STB
𒅋𒋃𒌋𒉌	STB
𒈬𒊹𒁹𒀀𒌨𒊓𒀭𒁯𒈗	LTB
𒊭𒌷𒋼𒀀𒀭	NEA
𒃻𒀭𒈜𒋛𒄿	NEB
𒃻𒀀𒃻𒊹𒁕𒂍𒀀𒈠𒀾𒌈𒃻𒂍𒊹𒊹	LTB
𒊭𒈗𒃮𒁍	NEA
𒁲𒈬𒀀	NEA
𒀭𒊩𒌆𒉌𒇷𒈫	SUX
𒈬𒊹𒌋𒁹𒋛𒇻𒆪𒀀𒋙𒈗𒈨𒌍	LTB
𒀫𒄑𒍪𒉌𒀸𒊮𒁉𒈬𒃻𒀭𒀫𒌓𒋡𒁉	STB
𒌓𒋫𒊺𒅕𒀀𒈾𒈗𒁁𒅀	MPB
𒀴𒊑𒅎𒀭𒀀𒉡𒌝	OLB
𒄿𒈾𒉺𒉌𒅟	MPB
𒈬𒈨𒌍𒀉𒋰𒋗𒌑	LTB
𒀀𒈾𒊹𒈠𒈾𒌁𒋛𒌅𒊹𒈠𒈾𒁍𒍮	STB
𒀸𒌗𒊺𒌓𒊹𒆚	NEA
𒌑𒍝𒇻𒇻	NEA
𒀭𒈨𒌍𒃻𒈗𒂗𒅀𒀉	NEB
𒅇𒁄𒄩𒆪𒅖𒌅𒉺𒉌𒋗	MPB
𒀭𒂗𒊹𒋗	SUX
𒊹𒋀𒋙	LTB
𒇽𒋋𒌑𒌓𒅅𒁉𒅆𒁺𒃻𒆠𒋀𒈨𒌍𒋙𒌋𒂗𒈨𒌍𒄩𒆷𒈨𒌍𒋙	LTB
𒇽𒍢𒊏𒉌𒂊𒃻𒊹𒈾𒀜𒉡	NEB
𒀀𒈾𒆪𒈪𒊹𒅆	NEA
𒁳𒁉𒋙𒀀𒁲𒌋𒅗𒃻𒂗𒈾	NEB
𒀠𒋰𒊏𒊮𒁉𒈠	NEB
𒅆𒁀𒆷𒂅	STB
𒁹𒄩𒋾𒅁𒄿𒅋𒆷𒂵𒄠	MPB
𒀀𒉿𒈪𒂟𒈨𒌍𒄿𒉡𒈠𒍑𒅆𒊏𒀜	MPB
𒊩𒉡𒉡𒌈𒀭𒈾𒈾𒀀𒀀𒈾𒉚𒌀𒈨𒌍𒀀𒈾𒊹𒃻𒈬𒋙𒊹	LTB
𒌉𒃻𒀀𒀀𒈾𒌓𒈬𒍝𒀀𒌓𒀉𒋫𒁷𒀪𒆪𒌝	LTB
𒌌𒄿𒌋𒌋𒄖𒊒𒈠	NEB
𒁹𒀭𒌉𒃻𒀀	LTB
𒉌𒇽𒊻𒊏𒀭𒉌𒊹𒌉𒊏𒊹𒌉𒃮	OLB
𒋳𒈠𒈗𒆳𒄩𒀜𒋼	MPB
𒀭𒈗𒅂𒌋𒉣𒂊𒈠𒅗𒂵𒌋𒅟𒇺𒈠𒄫	STB
𒅋𒇷𒆠𒀀𒄠	OLB
𒂟𒉌𒇽𒉽𒀸𒅆𒂟𒉌𒅀𒉡𒁺𒁺	STB
𒅇𒀠𒇻𒌑𒈪	MPB
𒊭𒀭𒂗𒍪𒅎𒄥𒀭𒉌𒌑𒇥	OLB
𒉌𒈠𒀀𒋫𒇽	NEA
𒇻𒌑𒂄𒈬𒀀𒈾𒂍𒅟𒀀𒈾𒁮𒈨𒌍𒅟𒀀𒈾𒌉𒈨𒌍𒅟𒀀𒈾𒇽𒈨𒌍𒃲𒅟	MPB
𒀀𒉿𒅋𒉌𒉌	OLB
𒇻𒂄𒈬𒀀𒈾𒊹𒌨𒋫𒆪𒈗𒆳𒉏𒆠𒋀𒅀	NEA
𒈛𒀭𒀉𒁮𒆬𒂵𒆤	SUX
𒆕𒄑𒁀	SUX
𒃻𒁇𒈨𒆠𒀀𒈾𒅕𒋾	NEB
𒋠𒅊𒅆𒈬	SUX
𒈠𒁕𒌅𒌑𒁲𒈾	NEA
𒊭𒅔𒁉𒆠𒁴𒉺𒈥𒌅	OLB
𒆳𒉽𒋙𒌑𒌑𒋗	STB
𒈣𒃶𒈨𒈛𒄩𒆳𒁉𒋫𒄘𒄑𒈬𒈾𒀊𒅅	SUX
𒌋𒅗𒁹𒀀𒍣𒊑𒊭𒆷𒅆𒂟𒅅	MPB
𒄿𒋼𒀀𒊒𒊒	NEA
𒊩𒋫𒊑𒁀𒀀𒌈	OLB
𒁹𒀀𒁉𒀭𒌓𒅆𒊭𒀴𒀭𒂗𒍪	OLB
𒊭𒅎𒂊𒀭𒅎	OLB
𒆳𒀀𒄯𒊑𒆏𒁀𒋗	MPB
𒀸𒁁𒈨𒌍𒊏𒄴𒍝𒌅𒌋𒉌𒆠𒄿𒄩𒀭𒉌𒂊	STB
𒇯𒇻𒄑	NEA
𒈠𒀀𒆬𒌓𒋧𒅟	NEA
𒀸𒊮𒁉𒇽𒂗𒌷𒈨𒌍	NEA
𒃻𒈗𒀀𒈾𒁇𒈨𒆠	NEB
𒈪𒅀𒈪𒉿𒈠𒄀𒅕	MPB
𒌸𒋼𒁉	SUX
𒁮𒀀𒃻𒀀𒃻	LTB
𒀀𒈾𒈬𒊒𒄣𒃻𒂍𒌋𒆠𒊒𒁀𒀀𒈬𒈨𒌍𒌋𒁹𒈜𒂁𒀀𒈾𒊹	LTB
𒄑𒇷𒄷𒋛𒌝𒈨𒌍𒃮𒊑𒆳𒀸𒋩	STB
𒁀𒊑𒂵𒑏𒑏𒑏𒑏𒍥𒍑𒀀𒈾𒆠𒁉𒃻	OLB
𒂆𒃸𒉈𒋧	SUX
𒂍𒈨𒌍𒀭𒈨𒌍𒃻𒀕𒆠𒍑𒆠𒌑𒊹	LTB
𒇻𒊌𒊺𒂊𒈾𒄴𒆗𒌓𒌑𒊑𒂊	STB
𒅇𒌑𒌌𒀭𒆷𒆪𒅇𒆷𒊒	MPB
𒀭𒈫𒆃𒋗	SUX
𒌷𒈗𒊑𒂗𒅀	MPB
𒄿𒉡𒈠𒂵𒀸𒋫𒆪	MPB
𒀀𒋗𒈝	NEB
𒅎𒊬𒊏𒂊	SUX
𒄿𒉆𒁷𒁍𒌑𒌓𒀀𒄩𒀀𒈩𒀀𒈾𒈬𒊒𒄣𒃻𒂍𒋗𒈫𒈬𒈨𒌍	LTB
𒄩𒀀𒁍𒅆𒀸𒆳𒆕𒀀𒁉𒅅	STB
𒁹𒀀𒄖𒌑𒀀𒆤	SUX
𒌗𒄞𒌓𒊹𒈬𒊹𒁹𒀀𒌨𒊓𒀭𒁯𒈗	LTB
𒀭𒃻𒆠𒆗𒀕𒆠𒊹𒌑𒍑𒀭𒋫	LTB
𒌀𒈨𒌍𒃻𒈨𒌍𒀭𒅥	STB
𒊑𒅎𒀭𒂗𒍪	SUX
𒀭𒊩𒌆𒍝𒈽𒁄𒈜𒈫	SUX
𒌑𒋛𒁉𒆷𒋙𒈗𒁁𒇷𒇺𒀪𒀠𒋙	NEA
𒊹𒂗𒇽𒄵𒋫𒀀𒀀𒀴𒃻𒈗𒂗𒐊	NEB
𒃻𒉺𒋼𒋛𒆤	SUX
𒀀𒈾𒌓𒈬𒍝𒀀𒌓𒈨𒌍𒁍𒌑𒌓𒀀𒄩𒀀𒈩𒀀𒈾𒈬𒌨𒊒𒄣	LTB
𒁕𒂍𒈗𒍢𒂊𒈦𒂊𒊺	SUX
𒃻𒈗𒁁𒉌𒌑𒊺𒁉𒇴𒈠	NEB
𒋛𒉌𒌓𒍝𒆳𒄿𒆠	MPB
𒀀𒄯𒋙	NEB
𒅎𒊩𒁕𒋫𒀀	NEB
𒁮𒋡𒀀𒋾𒈗𒄿𒆗𒊩𒌆	STB
𒁹𒄷𒈬𒀸	OLB
𒇽𒄩𒊑𒀀𒀀	NEA
𒇽𒈬𒈥𒊑𒋡𒀭𒄑𒊒𒁀𒈬𒈨𒌍	LTB
𒌋𒌋𒈠𒃻𒉆𒈠𒂍𒄿𒁁𒂖𒊩𒌨𒀸𒂍𒇽	STB
𒋗𒊹𒈗𒁁𒉌𒅀𒆷𒌑𒊺𒂖𒇻𒌑	NEB
𒀭𒌓𒅖𒌅𒀭𒊓𒈨𒄿	MPB
𒅆𒊹𒆰𒊹	NEA
𒁹𒀭𒈾𒈾𒀀𒈬𒆠𒋫𒅎𒍇𒇻𒁕𒆠𒊒𒁀𒀀𒃻𒌉𒃻𒈨𒌍𒉺	LTB
𒁹𒀭𒈾𒈾𒀀𒈬𒇽𒋃𒌉𒃻𒊹𒀕𒆠𒌗𒃶𒌓𒊹	LTB
𒅈𒆪𒌑𒋼	NEA
𒃻𒃻𒄭𒀀𒄿𒈾𒍦𒋾𒐊𒀀𒈠𒀀𒌅	NEB
𒊹𒂗𒀉𒁕𒀜𒃻𒉌𒂊	NEA
𒂍𒋗𒌈𒆠𒉘𒂷𒉌	SUX
𒌷𒋼𒀀𒀭𒌋𒄥𒀀𒈾𒌋𒅗𒈠𒁖𒌓𒃻𒈗𒂗𒅀𒌑𒍝𒀀	NEB
𒁹𒀭𒂗𒍪𒁁𒂖𒉌𒉌𒉺𒊩𒍑𒁇	OLB
𒊹𒂗𒋼𒀀𒅕𒊹𒀭𒌓𒆰𒁀𒃻	NEA
𒈨𒌍𒉺𒃻𒈜𒌈	LTB
𒋫𒌷𒍝𒉼	NEA
𒌉𒃻𒀀𒈤𒋥𒂊𒋛𒀀𒌈𒌓𒈬𒉺𒋡𒊑	LTB
𒊹𒈠𒈾𒈨𒊹𒅆𒊹𒅆𒆜𒁍𒍥𒍮𒊑𒂊𒀭𒂊	STB
𒌓𒊹𒄰𒀸𒋢𒌑𒆠𒈠𒄫	STB
𒈬𒍮𒌑𒃻𒌋𒌋𒂗𒆤𒆠𒂄𒉡	STB
𒇷𒋗𒋫𒀀𒌦𒈨𒌍𒋙	STB
𒅇𒍑𒅆𒊏𒉌𒊹𒈨	MPB
𒈠𒊍𒇡𒌓	NEB
𒋾𒅇𒋾	MPB
𒋗𒋾𒀀𒁹𒀭𒌓𒈾𒍢𒅕	OLB
𒃻𒄿𒇷𒀪𒌑	NEB
𒌅𒈛𒄩𒄠	STB
𒈠𒀀𒁍𒌓𒀭𒉌𒌓𒆠𒄿	NEA
𒄭𒉺𒈾𒋢𒉡	NEA
𒋀𒀊𒆠𒈠𒅟	SUX
𒅖𒋙𒌑𒈠𒆷𒀉𒁲𒈾	NEB
𒋫𒆍𒃲𒈤	STB
𒄿𒈾𒊮𒁉𒅆𒀀𒉡𒌝𒈠	MPB
𒄀𒅖𒈝	OLB
𒊩𒁁𒉌𒅀	STB
𒂊𒌑𒄫𒈠𒊹	NEA
𒀭𒈨𒁶𒊷𒀭𒊭𒆷	SUX
𒀭𒂗𒀭𒉺𒀭𒊹𒊭𒌷𒀏	NEA
𒃻𒀀𒈾𒉿𒄩𒋾	NEB
𒂍𒀭𒅎𒅟	SUX
𒌌𒈤𒊩	NEB
𒁹𒆠𒁷𒀭𒈹	LTB
𒁹𒀭𒈾𒈾𒀀𒈬𒊹𒀸𒀭𒁷𒌋𒆠𒄿𒆷𒀉𒆗𒉡𒈪𒋻	LTB
𒈬𒍪𒂠𒉣𒇬𒃶𒅎𒅆𒆕𒆕	SUX
𒃻𒋗𒊹𒈗𒋗𒌑𒆠𒄿𒊮𒁍	NEB
𒌨𒋢𒌋	STB
𒄿𒈾𒌗𒊹𒄰𒁹𒄀𒇷𒅀𒇽𒆥𒅀𒅇𒁹𒈠𒉌𒂊𒇽𒆥𒋗	MPB
𒁹𒀭𒈾𒈾𒀀𒈬𒃮𒁉𒀀𒈾𒊹𒂆𒆬𒌓𒋡𒇻𒌑𒄑𒋫𒌁𒊏𒉡	LTB
𒂗𒅀𒆷𒀀𒉺𒀜𒋻	MPB
𒁁𒅀𒇽𒈨𒌍𒈠𒍝𒅈𒋾𒀀𒈾𒌷	MPB
𒀭𒁁𒀖𒀭𒈨𒌍𒀭𒁁𒀖𒀮𒉌𒋾𒋫𒀖𒌅𒀸𒆳𒆪𒉡	STB
𒊭𒊑𒅎𒀭𒂗𒍪	OLB
𒊹𒌑𒊕𒆠𒀭𒋫𒅎𒋛𒁲𒁕𒋻𒋗𒈫𒉡𒈬𒋳𒌦𒈨𒌍𒊹𒌑𒊕𒆠	LTB
𒅆𒊹𒆰𒁺𒉌𒃮	NEA
𒀭𒊩𒌆𒋚	SUX
𒊹𒀭𒅟𒁇	NEB
𒇽𒌈𒍣𒊑𒀀	SUX
𒁹𒃻𒋧𒈬𒈗	LTB
𒃻𒁹𒊌𒂵	STB
𒌝𒈠𒁹	MPB
𒆠𒄿𒀀𒄩𒈨𒌍𒊓𒀜𒊒𒄑𒍝𒍪	NEA
𒌑𒋛𒊑𒅁𒂗𒉣𒋙𒉡	NEA
𒊭𒀭𒂗𒍪𒈠𒄫	OLB
𒀭𒂗𒆤𒍣𒉡𒌉𒀭𒂗𒆤𒇲𒆤	SUX
𒅇𒊹𒋢𒈦𒆠𒊒	NEB
𒊹𒄑𒄖𒍝𒂡𒁕	SUX
𒍝𒄯𒋫𒅟𒌦𒁕𒀠𒆷	NEB
𒁹𒀭𒈤𒌝𒈪	OLB
𒀭𒊩𒌆𒉽𒌋𒌓𒆤𒁮𒁉𒊩	SUX
𒁹𒀭𒋾𒀪𒄿𒆪𒋢𒌋𒁹𒀭𒋾𒀪𒄿𒆪𒋢𒌉𒋙𒈗𒈨𒌍	LTB
𒀭𒊩𒌆𒍪𒀊𒀭𒇡𒉺𒉌𒌈𒁮𒁉𒊩	SUX
𒌓𒀉𒋾𒇽𒈛𒈨𒌍	NEB
𒌦𒈨𒌍𒀀𒂵𒉡𒌓𒌌𒀾𒁍𒌓	NEB
𒅋𒆷𒆪𒀉𒋾	NEB
𒊹𒌉𒃻𒋗𒆸𒆸𒈨𒌍𒉺𒌈𒃻𒆠𒊒𒁀𒀀𒈬𒈨𒌍𒆠𒊒𒁀𒀀𒈬𒈨𒌍	LTB
𒃻𒉌𒋾𒌉𒊩𒋢𒀀𒈾𒊹	NEB
𒀭𒊩𒌆𒆯	SUX
𒊹𒈬𒀭𒈾𒈨𒌍𒄿𒊩𒅆𒈠𒀀𒈾𒊹𒌓𒈬𒃻𒁁𒀠𒅖𒋫𒃶	LTB
𒀜𒈬𒌑𒆠𒄿𒉡	STB
𒈾𒀜𒉡	OLB
𒂍𒀭𒈗𒄊𒊏𒃻𒆠𒆗𒀕𒆠𒊹𒌑𒍑𒀭𒌑𒅎𒋛𒁲𒁕	LTB
𒊹𒀭𒊹𒌓𒊹𒆚𒅆𒇲𒅟𒁺𒀭𒊮𒆳𒄭𒀊	STB
𒊭𒉌𒌓𒄿𒈾𒄩𒄷𒄭𒅖	MPB
𒊹𒀯𒈨𒌍𒆠𒀭𒊹𒁺𒈨𒌍	STB
𒀭𒈗𒃶𒅅𒆷𒀭𒅎	SUX
𒀭𒊩𒌆𒅔𒋼𒈾𒈫𒄥	SUX
𒇽𒌉𒆥𒊭𒈗𒊭𒉌𒅀𒉡	MPB
𒆍𒉡𒌓𒁺	STB
𒅇𒇻𒌑𒀜𒁲𒅔	MPB
𒀀𒈥𒌋𒉌𒌷𒈨𒌍𒉌𒌋𒊏𒀾	NEA
𒊹𒇽𒆥𒄄𒀀𒈨𒌍	OLB
𒃻𒊩𒉏𒈠𒆠𒃻𒊩𒋫𒁀𒇻𒄿𒌓𒃻𒊩𒄴𒆷𒈪𒌓𒀀𒈾𒋗𒌌𒈝	NEB
𒅇𒀀𒉡𒌝𒈠𒄿𒅋𒆷𒀝	MPB
𒁹𒍣𒁉𒊑𒌈	OLB
𒀴𒈨𒌍𒅟𒇽𒄩𒍝𒈾𒋼	NEA
𒁹𒇽𒀭𒋀𒆠𒊏	LTB
𒊭𒈗𒂗𒇷𒅖𒁓𒀭𒉌	NEA
𒇽𒈠𒀝𒌅	NEA
𒃻𒉈𒊒𒃻𒀉𒍣	SUX
𒀭𒉈𒋜	SUX
𒅆𒌨𒆳𒉏𒈠𒆠𒌋𒈥𒌅𒆠	STB
𒅆𒊹𒊹	SUX
𒌝𒈠𒁹𒋗𒉿𒅈𒁕𒋫𒀴𒅟𒈠	MPB
𒀭𒆪𒆍𒀭𒋼𒀀𒄷𒄩𒃻𒌷𒃻𒂵𒈩𒊑𒅎𒂅	STB
𒂗𒁁𒇻𒀭𒂗𒉡𒄀𒀭𒁲𒋻𒀭𒂗𒉡𒄀𒊹𒂗𒁁𒇻	STB
𒃻𒈗𒂗𒐊𒈠𒀪𒁺𒌅	NEB
𒋗𒉡𒅇𒇽𒈨𒌍𒈪𒅆	MPB
𒀸𒄑𒆪𒆗𒉡𒆳𒄉	STB
𒀀𒃻𒀀𒃻𒃻𒋫𒇽𒆕𒍑𒈨𒌍𒌋𒌆𒇻	LTB
𒀸𒉺𒅁𒆷𒌑𒀀	NEA
𒄑𒊒𒁀𒋙𒇽𒆭𒂍𒌑𒌓𒅆𒊹𒀭𒌈𒀭𒉽𒈛𒀭𒈹𒀭𒃽𒂔𒌋𒀭𒈨𒌍𒂍𒈨𒌍𒋙𒉡𒃮𒁉	LTB
𒌑𒂇𒍑𒆸𒌑𒉆𒋾𒆷	STB
𒇽𒂊𒆗𒌓𒄿𒋛𒉌𒉡𒊺	NEA
𒄿𒊓𒅟𒉡	NEA
𒋗𒊹𒋢𒉡𒄿	NEB
𒇽𒋋𒌑𒌓𒈬𒈨𒌍𒅅𒁉𒅆𒁺	LTB
𒌈𒄥𒂊𒉈	SUX
𒀭𒊓𒈨𒄿𒌉𒀭𒌓	MPB
𒀸𒅆𒋙𒀀𒉺𒅁𒊏𒂊	NEA
𒉽𒊹𒍜𒄭𒀀𒁀𒊩𒌋𒁄𒂅	LTB
𒅇𒂍𒃲𒅆𒂟𒈨𒌍𒌷𒊺𒄴𒆷𒇷𒆠	MPB
𒊹𒋙𒉡𒇽𒆥𒈾𒀀𒋫	NEB
𒇽𒌷𒌅𒊩𒋾𒆠𒄿𒊑𒁍𒈾	MPB
𒇽𒈬𒈥𒄣𒄑𒊒𒁀𒈬𒈨𒌍	LTB
𒄑𒍝𒊍𒇷𒅁𒌈𒌨	MPB
𒌀𒌉𒀜𒋙𒄤𒋀𒋀𒋙𒄤𒉣𒈨𒌍𒈿𒈨𒌍	STB
𒍜𒄊𒈨𒌍𒅟𒇽	MPB
𒊭𒆳𒄣𒌋𒂊	NEA
𒀭𒃶𒅅𒀭𒀫𒌓	SUX
𒌉𒊩𒃻𒁹𒀭𒈾𒈾𒀀𒈬𒈤𒊒𒌑𒂊𒋛𒀀𒌓𒈬𒇽𒉺𒋡𒊑𒁹𒌋𒅗𒄭	LTB
𒊭𒂍𒃲𒉋𒆪𒊭𒈨𒈨𒉌𒄿𒁀𒀾𒋙𒌋𒉌	NEA
𒅇𒆠𒀀𒄠	MPB
𒊭𒄿𒈾𒈠𒁲𒂊	OLB
𒅇𒅔𒉌𒊑𒊑𒊺	MPB
𒊮𒁍𒊭𒈗𒂗𒅀𒇻𒄭𒂵	NEA
𒊭𒊓𒄠𒈪𒋻	OLB
𒅇𒆟𒆟𒍏𒇻𒌑𒊭𒀝𒉡𒄿𒈾𒍜𒄊𒈨𒌍𒋗𒉡	MPB
𒋙𒉡𒁹𒀭𒈹𒌉𒈨𒌍𒋙𒀀𒈾𒊹𒀀𒈾𒌓𒈬𒍝𒀀𒌓	LTB
𒌝𒈠𒂄𒈬𒀀𒈾𒁷𒌁𒆠𒀀𒀀	NEB
𒀉𒋾𒋙𒉌𒀉𒋫𒇡	NEB
𒊭𒁹𒀭𒅎𒈠𒌨	MPB
𒍠𒄩𒁺	SUX
𒀀𒈾𒉣𒆠	OLB
𒇽𒈬𒁺𒌉𒃻𒌉𒃻𒌉𒃻𒀀𒈨𒌍	LTB
𒅇𒌉𒃻𒀀𒀸𒆠𒊒𒁀𒀀	LTB
𒌑𒊭𒊑𒀀𒄠𒆜𒊹	OLB
𒉿𒉺𒋗𒅀𒀀𒅆𒄿𒉡𒈠𒅖𒌅	MPB
𒀸𒌋𒅗𒊭𒉿𒉌	NEA
𒁮𒉡𒈪𒉭	SUX
𒅓𒀭𒅓𒁉𒆳𒉏𒈠𒆠𒆤	SUX
𒁹𒀭𒀀𒀀𒆗𒆷	SUX
𒀸𒂗𒆤𒆠𒀀𒈾𒂗𒉣𒆷𒀉𒋫𒅆𒄑𒍪	NEB
𒊭𒊹𒋼𒀀𒀀𒀀𒊹𒌓𒉡𒌋𒀀𒊑	NEA
𒉡𒄿𒈾𒁷𒌁𒆠𒀉𒋫𒁷	NEB
𒉆𒄩𒅈𒋾𒀀𒉌𒇻𒄯𒍪𒀊	OLB
𒊹𒈠𒈾𒆬𒌓𒋡𒇻𒌑𒄑𒋫𒌁𒊏𒉡𒃻𒁹𒋛𒇻𒆪𒉽𒁀𒉡𒌑𒌓	LTB
𒄿𒊓𒃶	NEA
𒌦𒋡𒁹𒆷𒁀𒅆	LTB
𒁹𒄿𒁷𒀭𒈾𒈾𒀀𒄖𒍝𒇲	OLB
𒊩𒁉𒃻𒊩𒆳𒃻𒊹𒅟𒄿𒋻𒊒	NEB
𒂟𒈨𒌍𒅀𒅇𒋡𒁺𒄑𒇀𒈨𒌍𒅀	MPB
𒀭𒉺𒀭𒀫𒌓𒀀𒈾𒈗𒂗𒐊	NEA
𒌦𒈬𒆪	STB
𒇽𒇽𒅇𒆷𒁀𒀭𒄄𒄄𒁕	SUX
𒌝𒈠𒀀𒀀𒈾𒈗𒁁𒉌𒅀𒀀𒈠	NEB
𒈾𒃻𒀜𒀀𒁺𒌑	NEB
𒇻𒌑𒇽𒌉𒁷𒌁𒆠	NEB
𒌌𒄑𒆷𒀀	NEB
𒀀𒌉𒃻𒇽𒋛𒌓𒃻𒂵𒊹	LTB
𒄥𒈠𒋫𒈥𒊩𒀀𒈾𒁕𒀊𒋾𒍝𒆪𒋾𒋼𒄑𒈨𒀀𒈾𒆪𒌋𒊑𒃻𒁖𒃶𒉌𒅟𒍢𒋾𒌅𒊺𒈩	STB
𒀀𒀀𒃻𒀀𒃻	LTB
𒀭𒉡𒍂𒂵𒋗	SUX
𒌦𒋡𒁹𒆷𒁀𒅆𒋀𒋙	LTB
𒊹𒀯𒌨𒈤𒀯𒈨𒌍𒋙	STB
𒂗𒐊𒆬𒌓𒂠𒃼𒊭𒇽𒉺𒇻𒈨𒌍𒀸𒊮𒁉𒉌𒅁𒍣𒀸𒋩𒀀𒀀	NEA
𒄿𒁲𒆠𒄿𒊮𒁀𒀀𒀉𒋾	NEB
𒀸𒌋𒅗𒀲𒆳𒊏𒄠𒈨𒄿𒌑𒈠𒀀	NEA
𒈬𒀕𒆠𒂵𒅇𒀉𒁮𒁉	SUX
𒀀𒈾𒈾𒍝𒅈	MPB
𒊹𒀯𒀸𒆠𒀯𒉺𒉈𒊕𒀀𒋛𒀀𒌍𒁇𒄷𒄭𒋫𒁄𒌋𒆍𒀭𒊏𒆠	STB
𒉺𒈥𒌅𒈨𒌍𒇽𒆠𒋩𒊏𒆠	OLB
𒋗𒌌𒁺	SUX
𒈬𒋙𒉡𒍠𒊒𒄠𒈥𒋞𒆕𒄣𒊒	STB
𒀭𒆘𒊷𒂵𒋗	SUX
𒈗𒀀𒈾𒈗𒉡𒉽𒋾𒄿𒉺𒅁𒌓	NEB
𒌅𒄩𒄠𒁀𒊍	STB
𒁹𒀀𒉈𒀭𒅎	OLB
𒀴𒈨𒌍𒅟𒊹	NEB
𒀭𒄖𒆷𒀀𒍪𒃲𒆷𒌓𒃲𒌓𒈪𒉭𒋫𒉌𒄷𒀸𒊮𒁉𒆪𒉡	STB
𒀀𒈾𒈠𒁖𒌓	NEB
𒊹𒀭𒀫𒌓𒆰𒆕	NEA
𒀀𒈾𒊩𒍑𒁇	OLB
𒑛𒈠𒈾𒉆𒊒𒌈𒃻𒀀𒀊𒁀𒊓𒀭𒁲𒋡𒇷𒌅𒀀𒄭𒂊𒋫𒈥𒊩	STB
𒅆𒊹𒀭𒉺𒊓𒄒	NEA
𒌉𒍝𒀝𒉌𒉌	SUX
𒀭𒈾𒈾𒀀𒈬	LTB
𒌑𒋼𒊒𒉌𒋗	OLB
𒌉𒊩𒀀𒉈𒆠𒅔	SUX
𒊹𒂆𒆬𒌓	SUX
𒀭𒀀𒉡𒉌𒌈𒊹𒃻𒆯𒆠𒂍𒌌𒈦𒉺𒈜𒀀𒂵𒉈𒆠	STB
𒊭𒈣𒉌𒁾𒀀𒇉𒍣𒆷𒆪	OLB
𒊭𒈗𒂗𒅖𒁓𒀭𒉌𒈠𒀀𒂗𒉣𒅟	NEA
𒀸𒄑𒆪𒄤𒀝	STB
𒊭𒇷𒁉𒀉𒀹𒁯𒉺𒋼𒋛𒀭𒌓	OLB
𒀭𒈨𒋗	SUX
𒃻𒄿𒈬𒊒𒋙𒉡𒋾𒌌	NEB
𒁹𒌑𒁇	LTB
𒁹𒀀𒉿𒇷𒅀	OLB
𒁹𒂍𒀀𒄿𒁷𒉆	OLB
𒀀𒈾𒁀𒆳𒍣𒈨𒌍𒃻𒈗𒁁𒉌𒐊	NEB
𒊭𒈨𒈨𒉌𒀀𒊮𒋙	NEA
𒀭𒈩𒇴𒋫𒌓𒁺𒀀	OLB
𒀭𒈫𒄴𒈨𒋗	SUX
𒇽𒈬𒁺𒌉𒃻𒌉𒃻𒌉𒃻𒀀𒈨𒌍𒌋𒊹	LTB
𒀴𒅟𒀊𒋫	OLB
𒅇𒀀𒈪𒈠𒀀𒈾	MPB
𒀉𒋾𒉌𒁺𒈾𒀀𒁲𒊹𒌒𒁀𒌓𒂦𒉌𒌓	STB
𒅇𒉿𒌍𒈨𒂗𒀀𒉿𒋼𒅀	MPB
𒁁𒇷𒅀𒆷𒆠𒄿	MPB
𒀉𒆗𒉡𒀸𒊮𒁉	NEB
𒌉𒃻𒀀𒈨𒌍𒌉𒃻𒀀𒊹	LTB
𒀀𒈾𒈗𒋙𒁺𒆚	STB
𒅇𒄠𒈠𒆪𒌓𒌋𒅗𒅀𒊬𒈨𒌍𒅀	MPB
𒅋𒇷𒅟	NEB
𒈠𒀠𒀀𒈾	NEB
𒆠𒄿𒃻𒉌𒈨𒌍𒀸𒊮𒁉𒍜𒈨𒌍𒆪𒉡𒅕𒊐𒌋𒉌	STB
𒌉𒆠𒉘𒂷𒉌𒅕	SUX
𒀭𒈾𒁉𒌝𒈠𒌨	OLB
𒇽𒆕𒍑𒌋𒌆𒇻𒅎𒄭𒀀𒃻𒂍𒀭𒈨𒌍𒃻𒀕𒆠𒌑𒈥𒊩𒈠𒂗𒊹	LTB
𒁹𒌉𒊩𒅕𒍢𒁴	OLB
𒀭𒋀𒆠𒀭	SUX
𒊭𒋫𒈗𒂗𒅀𒅋𒋢𒈬𒌋𒉌	NEA
𒀀𒅆𒅁𒀀𒈾𒌷𒀀𒇥𒀀𒉿𒈪𒇽𒇻	MPB
𒈗𒌒𒈨𒌍𒄿𒁁𒂖	STB
𒀭𒌨𒈨𒌈	STB
𒅆𒊹𒄩𒃻𒈾	NEA
𒀭𒈨𒁰𒀭𒊭𒌓𒍢	SUX
𒌓𒅗𒁇	SUX
𒀭𒀀𒉡𒌝𒉌𒉌𒉺𒀀𒋛𒊑	OLB
𒅔𒉆𒊒	OLB
𒀭𒅎𒃻𒌷𒆳𒁀𒀭𒆠𒈫	STB
𒌅𒈤𒄩𒄴	STB
𒅗𒅗𒆷𒀾𒋙	NEA
𒉈𒂊𒈬𒀸𒂍𒂗𒂊𒉌	NEA
𒇻𒌑𒌑𒁺𒌑𒆠𒄿	NEB
𒆳𒄠𒆠𒄿𒈠𒆪𒌓	MPB
𒌅𒋻𒊐	STB
𒀭𒈨𒌍𒃲𒈨𒌍𒃻𒀭𒂊𒆠𒁴𒀀𒅆𒁍𒋼	STB
𒁹𒅈𒋫𒀸𒋗𒈠𒊏𒈨𒌍	MPB
𒊭𒀀𒈾𒈗𒁁𒉌𒅀	NEA
𒉌𒋛𒅆𒆠𒄿𒉿𒄿𒉌𒀀𒈾	NEA
𒁮𒈗𒌶	SUX
𒇸𒇷𒅟𒀀𒉡𒊑𒅅	NEA
𒌉𒈨𒌍𒆪𒉡𒌉𒊩𒈨𒌍𒆪𒉡𒇷𒁲𒉡𒆠𒈲𒃻𒋗𒋛𒆪𒉡	STB
𒃮𒁉𒀉𒋾𒊹𒌋𒋀𒈨𒌍𒋙𒌉𒈨𒌍𒃻𒀀𒃻	LTB
𒂼𒂵𒃶𒊩	SUX
𒅤𒊭𒀭𒂗𒆤	SUX
𒀸𒀸𒀸𒀸𒀸𒀸𒊺𒄥	SUX
𒌑𒊑𒇷𒄷𒈠𒌓𒁺𒈨𒌍𒅖𒊺𒄖𒌑	STB
𒊹𒀯𒈨𒌍𒀸𒊮𒋙𒁺	STB
𒃲𒁉𒊹𒀭𒉺𒉽𒀸	NEA
𒀠𒋰𒊏𒊹𒀭𒂗𒋀𒈬	NEB
𒀀𒃻𒇽𒉌𒋩𒊕𒆠𒀭𒋫𒅎𒈥𒌅	LTB
𒌉𒃻𒊹𒑛𒌑𒍑𒆠𒌑𒅎𒆳𒊏𒁕𒀀𒈠𒀾𒌈𒃻𒁉𒈩𒋙𒉡𒊹𒌑𒊕𒆠𒀭𒋫𒅎𒋛𒁲	LTB
𒂇𒌓𒉣𒆠𒆤	SUX
𒅂𒅂𒃷𒃷𒃷𒀀𒊮𒊹	SUX
𒌑𒈦𒃻𒊒	NEB
𒅇𒄿𒅆𒄑𒍪𒉌𒌓𒄭𒇷𒁀𒆬𒄀𒃻𒊏	MPB
𒉌𒅕𒈬𒅖𒁺	STB
𒅇𒋗𒌓𒉿𒉿𒊺𒊒	MPB
𒀀𒉿𒋾𒋳𒈠𒊭𒈪𒈗𒀀𒈾𒀴𒋗	MPB
𒅆𒊹𒆠𒆥𒆷𒉡𒇽𒃲𒆠𒈲𒃻𒄊𒊹	NEA
𒄩𒊏𒂵𒋾𒅟𒌅𒋫𒊏𒈠𒑚𒈠𒈾𒍏𒅈𒄷	STB
𒊭𒀜𒋫𒍝𒅈𒅁𒉺𒇻𒄿𒁕𒋗𒀭𒌉𒍣	STB
𒈨𒌍𒋙𒉡𒌋𒇽𒂗𒈨𒌍𒄩𒆷𒈨𒌍𒋙𒉡𒁹	LTB
𒅇𒀀𒄭𒀀𒁴𒍣𒂵	OLB
𒊹𒌋𒈪𒋻𒌑𒊕𒆠𒀭𒋫𒅎𒈥𒌅𒁕𒂍𒌉𒃻𒊹𒌋𒈪𒋻𒌑𒊕𒆠𒆠𒋫	LTB
𒃻𒅟𒀀𒁺𒄿𒈾𒇽𒈾𒄬𒄿𒉆𒍝𒊒	NEB
𒆠𒄿𒀀𒈾𒈗𒂗𒐊𒆷𒌌𒋼𒇷𒌑	NEB
𒁁𒈠𒁁𒂗𒉡𒀸𒆳𒆕𒀀𒁉𒅅𒅆	STB
𒌉𒃻𒀀𒈨𒌍𒀀𒈾𒌓𒈬𒍝𒀀𒌓𒀉𒋫𒁷	LTB
𒆳𒆠𒁁𒇷𒅀𒀀𒁲𒀀𒍣	MPB
𒍣𒂵𒃻𒋗𒀭𒂗𒍪𒊺𒈪	OLB
𒇸𒇷𒆪𒊹𒀲𒂊𒁕𒉡𒋾	NEA
𒂊𒋩𒌓𒈬𒉺𒋡𒊑𒀀𒈾𒌋𒅗𒄭𒄑𒊒𒁀𒈨𒌍𒈬𒈨𒌍𒊹	LTB
𒄿𒃻𒉺𒊏𒀀𒆠𒂊𒆷𒀊𒆳	NEA
𒅇𒈪𒅎𒈬𒊭𒈾𒁕𒀭	MPB
𒄿𒄩𒊍𒊓𒋢𒄷𒌓𒊮𒁉𒂟𒄭𒀀𒊮𒈗𒄭	STB
𒁹𒁀𒀸	OLB
𒌓𒂍𒐐	SUX
𒊭𒅖𒌅𒂍𒅆𒁾𒅋𒇷𒆠𒀀𒄠	OLB
𒁹𒌋𒅗𒁲𒅁𒁉𒃻𒈗𒂗𒅖𒁓	NEB
𒋗𒉡𒊹𒈠𒈾𒆬𒌓𒅔𒁕𒄴𒊒𒋙𒅇𒅁𒋫𒋻𒋙	NEB
𒀀𒈾𒂗𒈗𒈨𒌍𒂗𒐊𒌨𒊒𒁍	NEB
𒅖𒌅𒌷𒌈𒉌𒅁𒅇𒁄𒄩𒆪	MPB
𒀸𒄷𒌨𒋛	NEA
𒀭𒉡𒌑𒉿𒉿𒅆𒊏𒋗𒈗𒊒	MPB
𒌉𒅟𒆬𒆤	SUX
𒈗𒁁𒇷𒀲𒀀𒂟𒁍	NEA
𒌋𒌆𒇷𒈗𒃻𒈗𒄿𒄫𒊒𒈠𒅁𒁍𒋗𒁾𒋝𒆪𒀸𒊮𒁉𒌌	NEB
𒀉𒋾𒀀𒄩𒈨𒌍𒅔𒉆𒊒	STB
𒀀𒃻𒀀𒃻𒇽𒆬𒁴𒀀𒈾𒌓𒈬𒍝𒀀𒌓𒀉𒋫𒁷	LTB
𒈠𒀀𒋫𒊮𒌗𒋞𒊓𒅈𒄩𒀜𒈠𒀀𒁕𒁀𒁍𒅆𒂟𒀸𒌋𒅗𒄭	NEA
𒁹𒀀𒌨𒊓𒀭𒁯	LTB
𒀀𒈾𒀴𒋗𒀲𒆳𒈨𒌍	MPB
𒂍𒈤𒆕𒀀	SUX
𒀀𒈾𒆪𒋗𒊹𒀀𒀀𒀸𒌋𒅗𒀀𒇉	NEA
𒆠𒀀𒋛𒁲	STB
𒊭𒊮𒁉𒆗𒉏𒁍𒁕𒂵𒂊𒈾𒋗	MPB
𒇽𒀀𒆥𒃻𒇽𒃲𒊕	NEB
𒊭𒅖𒌅𒆍𒃲𒌅𒌅	OLB
𒀀𒈾𒌉𒆍𒀭𒆠	NEA
𒈠𒀀𒀸𒅆	NEA
𒂍𒇉𒊏	SUX
𒅇𒉺𒋫𒅈𒅇𒇽𒀭𒅀	MPB
𒊹𒌉𒊏𒌉	OLB
𒅇𒄑𒇀𒄭𒀀𒀉𒁷𒀭𒉌	MPB
𒀠𒁉𒁹𒁹𒈦𒊬𒋫𒅔𒀝	SUX
𒁹𒃻𒀭𒈾𒈾𒀀𒆕𒀀	LTB
𒁹𒋫𒊑𒅖𒈠𒁴	OLB
𒂍𒀀𒈮𒀀𒉌	NEB
𒊭𒅖𒌅𒌓𒀕𒆠	OLB
𒊹𒊩𒊕𒀸𒊭𒀀𒉿𒆷𒌈𒈾𒃰	OLB
𒀭𒌓𒅀𒀀𒈾𒅀𒅆	MPB
𒅇𒀀𒉿𒋼𒈨𒌍𒀭𒉡𒌓	MPB
𒆠𒅁𒉌𒀭𒂗𒍪	SUX
𒌋𒅅𒄭𒁍𒉌	NEA
𒊭𒄩𒁕𒀭𒋗𒌨𒋗𒌓𒈛	OLB
𒈾𒁷𒀜𒇽𒌓𒁴𒈬𒈨𒌍	LTB
𒀀𒈾𒉺𒉌𒀭𒀴𒊑𒅎𒀭𒀀𒉡𒌝	OLB
𒁹𒅀𒆪𒌒𒀭𒀴	OLB
𒌓𒈬𒉺𒋡𒊑𒁹𒌋𒅗𒄭𒈪𒋻𒀸𒆠𒊒𒁀𒀀𒈬𒈨𒌍𒀉𒋰𒋗𒌑	LTB
𒈾𒍝𒅈𒀴𒆠𒋾𒋗𒅇𒌷𒋗	MPB
𒌑𒉿𒀸𒊬𒋗	MPB
𒀀𒈾𒌓𒈬𒍝𒀀𒌓𒀉𒋫𒁷𒆬𒌓𒀀𒀭𒑚𒈠𒈾𒉚𒂍𒌋𒆠𒊒𒁀𒀀𒈬𒈨𒌍	LTB
𒀀𒁉𒅀𒌈	OLB
𒁹𒃻𒁀	MPB
𒌑𒂵𒈥𒂊𒄵𒌓	NEA
𒀸𒂍𒌈𒋙𒈨𒉿𒊩𒋢𒂍𒊒𒄖𒁍𒋙𒄑𒅅𒄑𒋝𒆐𒆲𒉡𒌋𒆠𒊒𒁀𒋙𒃻𒆠𒁴	LTB
𒂷𒁾𒁀	OLB
𒅇𒀀𒈾𒈠𒄯𒁹𒀀𒈠𒀭𒄩𒀜𒁉	MPB
𒀀𒈾𒉺𒉌𒅟𒅇𒋼𒌍𒋼𒉏𒈨	MPB
𒍑𒀭𒌑𒅎𒋛𒁲𒁕𒀸𒋻𒌈𒃮𒇷𒌈𒃻𒂍𒈬𒈨𒌍𒊹𒈪𒋻𒌑𒍑𒆠𒌑	LTB
𒄩𒉌𒀹𒀭	SUX
𒈨𒌍𒀭𒂗𒈨𒊹𒊏𒆤	SUX
𒈬𒊺𒁉𒅔𒅥𒀀𒀸	SUX
𒆠𒋢𒇻𒂠𒃻𒈬𒉆𒄭𒀀	SUX
𒁹𒅆𒂟𒁴𒄿𒋻𒊓𒋢	STB
𒄷𒊺𒂟𒄷𒀖𒁀𒄠𒈠𒆳𒋢𒅥	STB
𒂍𒊹𒋼𒊹𒀉𒋫𒊮𒁉	NEA
𒈗𒂗𒅔	NEA
𒀭𒆠𒄖𒆷𒁮𒁉𒊩	SUX
𒄿𒅅𒄿𒁀𒀸𒅆	MPB
𒀯𒊕𒈨𒃻𒀸𒊮𒋙𒁺	STB
𒌋𒊑𒁍𒌑𒀸𒂍𒆪𒊑𒈬𒈨𒌍𒀉𒋰𒋗𒌑𒀀𒃻𒀀𒃻	LTB
𒅆𒌨𒍝𒂵𒂇𒂠	SUX
𒅇𒄿𒉡𒈠𒉿𒆷𒈬𒉡𒉌	MPB
𒊹𒂗𒃻𒄭𒀀𒈾𒅆𒀀𒆳𒈗	NEB
𒋡𒇻𒌑𒄑𒋫𒌁𒊏𒉡𒃻𒁹𒋛𒇻𒆪𒉽𒁀𒉡𒌑𒌓𒀀𒈾𒉚𒌀𒈨𒌍	LTB
𒌑𒈥𒊩𒀪𒌉𒃻	LTB
𒆠𒊒𒁀𒀀𒈬𒈨𒌍𒃻𒀀𒃻𒀀𒃻	LTB
𒀭𒊩𒌆𒋾	SUX
𒀭𒀫𒌓𒌉𒍑𒋧𒈾	SUX
𒀭𒋭𒁓𒄭𒂵	SUX
𒉿𒉿𒅆𒊏𒈗𒊒𒀲𒆳𒊏𒈨𒌍	MPB
𒍑𒆠𒌑𒅎𒍇𒇻𒁕𒂍𒌉𒃻	LTB
𒇽𒉽𒆪𒉡𒇷𒃻𒈜𒆪𒉡	STB
𒌗𒆥𒀭𒈹	SUX
𒁀𒀀𒄄𒄄𒁕	SUX
𒀭𒅆𒀀𒈾𒀊𒌌𒋗	SUX
𒇽𒈬𒊒𒊩𒈨𒌍𒂍𒈬𒈨𒌍	LTB
𒊹𒍣𒈨𒌍𒌑𒉿𒄿𒈪𒊹𒊭𒄿𒌅𒆪𒉏	MPB
𒇽𒋃𒀀𒃻𒀀𒀕𒆠𒌗	LTB
𒀀𒈾𒇽𒁾𒊬𒂍𒃲	NEB
𒊏𒋼𒈨𒌍	MPB
𒌑𒌌𒀠𒅟𒋾𒀀𒈾𒈠𒄯𒁹𒀀𒉿	MPB
𒄊𒀭𒀫𒌓𒈾𒍢𒅕𒂆𒍑𒊕	OLB
𒁹𒀭𒅎𒁁𒂖𒉌𒉌	OLB
𒌒𒇻𒉏	OLB
𒀀𒁹𒅎𒊺	LTB
𒅇𒌷𒀸𒀸𒈨𒌍𒈗𒊑𒀉𒋾	MPB
𒌝𒈠𒇽𒅀𒀀𒈾𒌷𒋫𒄴𒁕𒆠	MPB
𒀠𒆷𒈗𒈨𒌍𒈤𒊒𒋾𒅅	NEB
𒁹𒀭𒊩𒌆𒅁𒅁𒉌𒋗	OLB
𒌋𒇽𒆬𒁴𒌑𒌓𒊹𒀸𒇻𒀴𒈨𒌍𒃻𒄭𒋫𒋰𒀸𒃾𒋆𒇷	LTB
𒌒𒁍𒇻𒋫	STB
𒁹𒂍𒀭𒈾𒇷𒉿𒅕𒀜𒆤	OLB
𒀸𒈨𒉌𒄿𒁷𒉈𒋫𒀀𒉌𒉌	NEB
𒀀𒉡𒈠𒄿𒋗𒊺𒊒𒋗	MPB
𒀀𒈾𒈗𒁁𒉌𒐊𒌨𒊒𒁍	NEB
𒍣𒆤𒀯𒄈𒋰𒂗𒃲𒌑𒀯𒉺𒉈𒊕	STB
𒀀𒁺𒌑𒄿𒈾𒌋𒅗	NEB
𒉌𒌓𒅎𒈠𒈾𒆪	STB
𒆠𒄿𒌑𒁀𒀭𒀉𒋰𒅆𒀀𒈾𒄩	STB
𒍣𒂵𒃻𒋗𒀭𒂗𒍪𒊺𒈪𒉺𒀀𒋛𒀸	OLB
𒇽𒂗𒉣𒊌	NEA
𒅅𒋫𒊏𒊏	NEA
𒇽𒈾𒁷𒀪𒄑𒊒𒁀𒈬𒈨𒌍𒌑𒈥𒊩𒈨𒌍𒀀𒁲𒊹𒀀𒈾	LTB
𒆠𒄿𒊭𒈗𒂗𒄿𒃻	NEA
𒊭𒀀𒈾𒂍𒈛𒈨𒌍	OLB
𒇽𒁉𒃻𒀀𒀀	NEA
𒌉𒊩𒃮𒌉𒊩𒀀𒉌	OLB
𒊭𒀀𒄭𒅀𒊭𒁉𒅕𒂆𒍑𒈨𒌍	OLB
𒌑𒀀𒂗𒆤𒆠	SUX
𒋗𒋛𒍝𒆳	SUX
𒀀𒈾𒇽𒋗𒃮𒀀	OLB
𒅖𒀭𒌋𒄥𒁁	STB
𒄿𒈾𒉺𒉌𒈗𒊑	MPB
𒈦𒀸𒊮𒊹𒂆𒈨𒌍𒆬𒌓𒄿𒁺𒉡	NEA
𒌓𒈬𒉺𒋡𒊑𒁹𒌋𒅗𒄭𒂍𒈬𒈨𒌍𒀉𒋰𒋗𒌑𒀀𒃻𒀀𒃻	LTB
𒋧𒈬𒊹𒀭𒉡𒋼	NEA
𒊭𒂗𒉌𒆗𒄑𒂄𒈬	MPB
𒈬𒈠𒂗𒉣	NEB
𒋛𒇲𒇻𒄯𒄀𒅖𒀭𒌓	OLB
𒀭𒌋𒄥𒌋𒀭𒆷𒊍	NEB
𒁹𒀀𒁕𒉺𒀀𒈾𒉺𒉌𒀭𒀀𒉌𒊬𒊑𒀜𒋫𒋫𒆷𒀝	STB
𒄴𒊑𒄣	NEA
𒀭𒋞𒄯𒄖𒍣𒀸𒆠𒋗	SUX
𒀀𒈾𒈗𒌨𒁍𒌑𒈗𒀀𒈾𒋗𒊹𒌋𒌋𒈠	NEB
𒊭𒀭𒈨𒌍𒌷𒂊𒈥𒀴𒀭𒀝	MPB
𒇽𒂟𒈨𒌍	NEA
𒀸𒀾𒌒𒃻𒀜𒀜𒐊	NEB
𒈬𒈨𒌍𒌀𒈨𒌍𒌋𒌉𒈨𒌍𒃻	LTB
𒆷𒊌𒁕𒋫𒈬𒊒𒌋𒉌	NEA
𒀭𒈫𒉣𒌆𒈫	SUX
𒁹𒄤𒀭𒂗𒍪	OLB
𒀸𒊬𒌋𒂆𒀸𒁹𒁹𒁹𒁹𒁹	SUX
𒀭𒈾𒀀𒄩𒆷𒃻𒀀𒃻𒀀𒀀𒈾𒌓𒈬𒍝𒀀𒌓𒅆𒋾𒊹𒂆𒆬𒌓𒋳𒁍𒋙	LTB
𒀀𒊮𒂊𒋼𒊕𒂊𒋼𒍢𒀉	NEB
𒂟𒈨𒌍𒃻𒈗𒁁𒉌𒅀	NEB
𒅇𒊩𒌆𒁲𒂊𒈠𒋫𒃮𒁀𒀀	NEB
𒇻𒃻𒄭𒍪𒋙𒉡	NEA
𒊹𒊹𒀸𒅆𒇲𒋙𒂟𒅕	STB
𒆪𒌒𒋳𒆪𒌒𒋗	STB
𒊮𒁍𒌑𒉡𒋫𒉺𒆏𒈝	STB
𒌦𒋡𒁹𒀸	LTB
𒌅𒆗𒄷	STB
𒆠𒄿𒋡𒉌𒂊𒀸𒋆𒋛𒇽𒉽𒆪𒉡𒇻𒊩𒈜𒆪𒉡	STB
𒃻𒌌𒉌𒀀𒁕	SUX
𒁹𒆪𒀭𒍂𒇽𒄭𒃻𒁍𒈛𒌓𒄑𒍣𒌓𒄭𒀉𒇻𒁍𒋗𒌅𒊒𒉆𒊑𒅕	STB
𒇽𒀀𒆥𒌉𒈗𒄑𒋛𒅀𒄑𒉺𒅁𒊏	NEA
𒆃𒈬𒈾𒁺	SUX
𒊹𒋡𒈾𒀀	NEB
𒄿𒁷𒀹𒁯	OLB
𒊹𒀭𒌓𒀭𒈾𒈾𒀀𒀭𒃽𒃻𒊕𒌋𒀭𒈨𒌍𒂍𒋙𒉡	LTB
𒁹𒆷𒁀𒅆𒈤𒋥𒋺𒂊𒋛𒀀𒋺𒌓𒈬𒉺𒋡𒊑𒁹𒌋𒅗𒄭𒆠𒊒𒁀𒀀𒈬𒈨𒌍	LTB
𒌉𒊏𒀀𒈾𒀭𒈾𒁉𒌝𒋫𒀝𒆷𒆪	OLB
𒆠𒄿𒀉𒁲𒉡	NEB
𒊹𒂆𒀀𒊮𒊹	SUX
𒊺𒃻𒀭𒈾𒌋𒊩𒈠𒃻𒀀𒈾𒄑𒊒𒁀𒇽𒋋𒌑𒌓𒈬𒈨𒌍𒅅𒁉𒅆𒁺	LTB
𒀸𒄷𒌓𒊮𒁉𒋙𒂍𒆪𒊒𒌒𒁍𒋙𒅁𒋙𒆠𒁴	LTB
𒁹𒀭𒈾𒈾𒀀𒂊𒊑𒌍	LTB
𒊹𒂆𒆬𒌓𒉽𒁀𒉡𒌑𒀀𒃻𒀀𒃻𒀀	LTB
𒅆𒊹𒊺𒀀𒊮𒊹	SUX
𒄑𒊒𒁀𒋙𒇽𒆭𒂍𒌑𒌓𒅆𒊹𒀭𒌈𒀭𒈹𒀭	LTB
𒁕𒋻𒋝𒈬𒋳𒋡𒌦𒈨𒌍𒍑𒆠𒌑𒅎𒍇𒇻𒁕	LTB
𒁉𒀉𒈗𒁁𒉌𒄿𒉺𒅁𒌓𒃻𒉡𒉌	NEA
𒈗𒂗𒄿𒉌𒇷𒅅𒁉	NEA
𒂟𒍝𒁍𒂟𒍝𒁍	STB
𒉆𒄩𒅈𒋾𒄿𒁷𒀭𒌓	OLB
𒇷𒆷𒀀𒈠𒈾𒀸𒉼𒋫𒆪𒉡𒇺𒆲𒊩𒈠𒄭𒂵𒇻𒅅𒄒𒆪𒉡	STB
𒊺𒀪𒄿	STB
𒀸𒌷𒊑𒁁𒉌𒊕𒃶	NEB
𒊹𒊕𒀴𒈨𒌍𒊭𒀴𒊏𒈾𒍢𒅕	OLB
𒋀𒋙𒉡𒌉𒃻𒊹𒇽𒁃𒀀𒈾𒌓𒈬𒍝𒀀𒌓𒀉𒆗𒉡𒌑	LTB
𒄩𒆷𒁀𒀭𒂵𒈪𒅋	SUX
𒋾𒊏𒀾𒍪𒀊𒁶	SUX
𒊭𒀀𒈾𒉌𒉌𒄿𒁷𒉆𒃲𒉌	OLB
𒊭𒀀𒄷𒌝𒈛	OLB
𒅟𒉡𒄀𒈾	STB
𒀠𒋫𒌓	NEB
𒀸𒌋𒅗𒉌𒈬𒀀	NEA
𒀭𒂗𒆤𒌉𒁕	SUX
𒁹𒆷𒇽𒀊𒉣𒈾𒆠	OLB
𒀀𒈾𒈬𒊒𒄣𒃻𒄑𒊒𒁀𒈬𒈨𒌍𒊩𒊩𒆳𒆕𒌈𒇽𒈾𒁷𒈾𒀜	LTB
𒀭𒈹𒋢𒁄𒋢𒁄𒇷𒌅	SUX
𒁹𒇻𒍑𒌓𒈥𒀭𒅎	LTB
𒀀𒈾𒈗𒆳𒀸𒋩𒆠𒊒𒊏𒌝𒈠𒂍𒃲	NEB
𒁹𒌑𒍪𒉿	OLB
𒊹𒀀𒉺𒀀𒀀	NEA
𒑛𒈠𒈾𒊹𒂆𒉚𒄑𒊒𒁀𒈬𒈨𒌍	LTB
𒆷𒂊𒊏𒁍𒉌	NEA
𒆷𒈾𒍮𒌋𒉌𒋙𒉡	NEA
𒁹𒍪𒁍𒀸𒇷𒅕𒁉𒅖𒌉𒃮𒌉𒉌	OLB
𒊭𒅖𒌅𒈬𒋾𒀀𒁄	OLB
𒅆𒌓𒋾𒀀𒈾𒉺𒉌𒐊	NEB
𒊹𒋰𒉌𒄿	NEA
𒄶𒃲𒄦	SUX
𒌑𒌌𒉿𒌑𒌷𒆠	MPB
𒑏𒑏𒑏𒑏𒋡𒋡𒋡𒋡𒋡𒋡𒋡𒋡𒋡𒍥𒁕	OLB
𒐕𒐕𒐕𒐕𒐕𒐕𒐕𒐕𒐕𒐕𒐕𒐕𒐕𒐕𒐕𒐕𒐕𒐕𒁲𒊹𒊹𒁓𒁓𒁓𒁓𒌋𒌋	SUX
𒁀𒀀𒍣𒅇𒁀	MPB
𒀭𒊩𒌆𒅁𒈠𒀭𒋧	OLB
𒅎𒆳𒊏𒁕𒆠𒊒𒁀𒀀𒈬𒈨𒌍𒌉𒃻𒊹	LTB
𒇻𒊺𒁉𒅋𒂊𒄈𒌅𒋗	NEA
𒇽𒆠𒁀𒈨𒌍𒃮𒁍	NEA
𒀀𒁲𒊹𒅎𒋫𒀮𒁄	LTB
𒀭𒈗𒌉𒁕𒋗	SUX
𒂗𒈨𒋼	SUX
𒀀𒃻𒀀𒃻𒅇𒀀𒃻𒀀𒃻	LTB
𒅇𒀀𒉡𒌝𒈠𒊹𒇽𒈨𒌍𒀀𒋛𒊑	MPB
𒇻𒌑𒁲𒅁𒁍𒀀𒈾𒆪	NEB
𒅇𒇷𒉿𒀸𒊬𒀭𒉌𒈗	MPB
𒅇𒊩𒈠𒃮𒁉𒃻𒀀𒈾𒄑𒊒𒁀𒈬𒈨𒌍𒅅𒁉𒅆𒁺	LTB
𒁹𒂠𒍪𒌋	LTB
𒊭𒂊𒌀𒅗𒂍𒀀𒈜𒃲	OLB
𒁀𒋗𒌑𒃮𒁉𒀀𒈾𒑚𒈠𒈾𒊹𒈦𒂆𒆬𒌓𒋡𒇻𒌑𒄑𒋫𒌁𒊏𒉡	LTB
𒈗𒁁𒉌𒊌𒆪𒍑	NEA
𒀸𒌋𒅗𒋞𒈨𒌍𒈠𒊏𒆥𒄿𒊑𒆪𒉌	NEA
𒋩𒋙𒁺𒄑𒄖𒍝𒈗𒋾𒋙	STB
𒌋𒂗𒈾𒀀𒈾𒋗𒁄𒊹𒀭𒂗𒁕𒄿𒋼𒊒𒌒	NEB
𒄊𒉌𒂠𒈬𒈿	SUX
𒁹𒀭𒋾𒀪𒉺𒀜𒊒𒋢	LTB
𒄀𒄃𒆠𒇷𒅎𒁉𒊑𒅅𒋢𒃻𒄀𒌑𒀀𒍤𒆸𒂖𒉿𒌓𒈨𒂊𒁓𒆠	STB
𒊭𒄿𒈾𒆠	OLB
𒇽𒆗𒁕𒀀𒀀	NEA
𒌉𒀭𒅎𒌨𒊕𒇽𒁾𒊬𒇽𒄬	MPB
𒌅𒄩𒄠𒈠	STB
𒅇𒁁𒉌𒉌𒇷𒄿𒋼	MPB
𒅁𒌓𒉻𒆪𒊓𒉿	STB
𒄿𒈾𒁀𒆷𒀜𒍣𒅀𒅇𒇽𒅀	MPB
𒌨𒈝𒈠	SUX
𒂗𒅀𒅇𒀀𒉡𒌝𒈠	MPB
𒄴𒆷𒈬𒌋𒅥	STB
𒇽𒈬𒈥𒊩𒀭𒂍𒈬𒈨𒌍	LTB
𒌗𒃶𒃶𒀀𒌓𒊹	OLB
𒊭𒊹𒈦𒈠𒈾𒊹𒂆𒆬𒌓	NEA
𒆏𒁉𒈪𒅎𒈪	MPB
𒌝𒈠𒁹𒀜𒊏𒈹𒀴𒅟	MPB
𒋙𒁾𒊬	STB
𒊭𒂊𒄫𒌋𒉌	NEA
𒂊𒌀𒅗𒀭𒀫𒌓	OLB
𒇽𒈬𒁺𒌋𒌉𒈨𒌍𒃻𒀀	LTB
𒃻𒋗𒀀𒄷𒉿𒃼	OLB
𒀠𒁕𒀝𒆠	SUX
𒊹𒄑𒋸𒃽	OLB
𒀀𒃻𒆜𒋙𒉡𒇺	NEA
𒅖𒋼𒈨𒀀𒉿𒋼𒈨𒌍𒋗	MPB
𒌇𒈨𒌍	STB
𒈗𒆧𒃻𒋾𒄑𒄖𒍝𒌑𒆗𒁇	STB
𒅆𒌨𒀀𒄰	SUX
𒀀𒃻𒀀𒋙	LTB
𒄑𒁍𒊻𒋢𒌋𒌋	NEB
𒉌𒉌𒄿𒁷𒉆	OLB
𒈗𒁁𒇷𒅖𒌅𒌷𒋗𒅇	MPB
𒌓𒈪𒄿𒉡𒍑	STB
𒍝𒀀𒌓𒀸𒀭𒁷𒁍𒌑𒌓𒈬𒊒𒄣𒈬𒊒𒄣	LTB
𒊹𒃷𒀀𒊮𒊹	SUX
𒀀𒈾𒋾	MPB
𒀴𒈨𒌍𒉌𒊭𒊹𒂗𒀀𒀸𒂗𒋗𒊹𒋙𒉡	NEA
𒊹𒈨𒌍𒀉𒋫𒈾𒀭𒁉𒂅	STB
𒋗𒆲𒈠𒀸𒋗𒈝𒈨𒋙𒉡	NEB
𒀀𒈾𒈗𒂗𒅀𒀭𒌓𒅀𒀭𒅀	MPB
𒍪𒆪𒌋	STB
𒊮𒁍𒊭𒈗𒂗𒅀𒀀𒆗𒌋𒌋	NEA
𒆠𒅅𒁍𒌑𒀉	NEB
𒌝𒈠𒁹𒋫𒄀𒀴𒅟	MPB
𒈨𒌍𒉺𒊹𒉣𒇬𒃻𒂍𒈬𒈨𒌍𒊹𒌑𒍑𒀭𒌑𒅎𒋛𒁲𒁕𒉣𒇬𒃻𒊹	LTB
𒍣𒊮𒅅𒈬	SUX
𒀴𒃻𒀭𒈥𒌅	OLB
𒀀𒈾𒉺𒉌𒋙𒉡	NEB
𒁹𒄩𒄠𒈪𒊭𒄀𒅖	OLB
𒂵𒆗𒀀𒈾𒈗𒂗𒅀𒀭𒌓𒅀	MPB
𒊹𒀭𒉺𒊓𒄒𒊭𒋫𒇽𒊹𒄷𒋛𒈨𒌍	NEA
𒅇𒌷𒍑𒋼𒆠𒌷𒆠𒁹𒈗𒊑𒂗𒅀	MPB
𒊹𒀸𒌗𒃶	STB
𒀀𒈾𒈨𒊑𒌍𒈗𒍣𒂵	OLB
𒁀𒊑𒂵𒁀𒊑𒂵𒍥𒁕𒀀𒈾𒆠𒁉𒃻	OLB
𒁹𒀀𒄭𒉿𒁺𒌝	OLB
𒋗𒄿𒁹𒄷𒍝𒈝	OLB
𒊹𒊩𒊮𒄞	OLB
𒁹𒉌𒉌𒆠𒅁𒊑	OLB
𒌋𒃶𒉌𒄑	SUX
𒈠𒀪𒁕	NEA
𒄠𒈨𒋾𒊺𒄵𒀸𒊮𒁉	NEA
𒁉𒉌𒈾𒊍𒍝𒊒	NEB
𒊭𒁉𒌅𒅀	OLB
𒊹𒀲𒄯𒁀𒃶𒉌𒀸𒄊𒊹𒀭𒈦𒈦𒌑𒊺𒊐	NEA
𒀀𒈾𒄊𒈨𒌍𒂗𒅀	MPB
𒀭𒄭𒄊𒁔𒈤𒃲𒈫	SUX
𒋫𒌉𒈗𒁁𒉌𒐊𒀀𒈾𒊮𒌷𒄿𒋛𒋾𒄴𒊑𒋡𒊑𒂊𒈬𒀀𒈾𒈗𒄑𒍝𒁁	NEA
𒊮𒈪𒁖	OLB
𒋙𒉡𒆷𒋫	NEA
𒈨𒂊𒉡𒀀𒄖𒌑	STB
𒆷𒀀𒈪𒋾𒉺𒋾𒅕𒅖𒌅𒌷𒀀𒇥𒆠𒈨𒌍	MPB
𒊩𒈠𒀜𒌷𒍣𒁺𒈾𒆠𒊩𒆳𒋾	MPB
𒀠𒆪𒈪𒋡𒁺𒇽𒈨𒌍𒄩𒍝𒉌𒆪𒉡	MPB
𒀀𒊓𒀊𒌓𒆠𒄿𒈨𒂊𒀀𒈠𒌓	MPB
𒊭𒀭𒀫𒌓𒈾𒍢𒅕𒂆𒍑𒊕	OLB
𒊭𒄿𒈾𒈪𒁖𒌗𒉈𒉈𒃻𒌓𒊹	OLB
𒉌𒉌𒅖𒈾𒁲	SUX
𒀭𒊩𒌆𒃲𒂊	SUX
𒀀𒈾𒇽𒊮𒄞𒊩𒊮𒄞	OLB
𒀉𒋫𒍢𒆠𒄿𒉿𒄿𒀭𒉌𒄿𒋡𒁉	NEB
𒉿𒍥𒁕	OLB
𒌋𒊩𒈠𒃮𒁉𒃻𒀀𒈾𒄑𒊒𒁀𒈨𒌍𒈬𒈨𒌍𒅅𒁉𒅆𒁺𒃻𒆠𒇽𒋀𒈨𒌍𒋙𒌋𒂗𒈨𒌍𒄩𒆷𒈨𒌍𒋙	LTB
𒁕𒂍𒅋𒋗𒁀𒉌	SUX
𒄿𒉡𒈠𒊩𒈠𒀜	MPB
𒀭𒈫𒅆𒍝𒈹𒋗	SUX
𒌅𒌓𒈛	STB
𒈦𒆜𒁍𒄿𒋾𒅆	NEA
𒍪𒁲𒂊𒇽𒆥𒄄𒀀	OLB
𒋼𒀕𒍨𒈬	SUX
𒂗𒅀𒅖𒈨𒌍𒊭𒄊𒈨𒌍	MPB
𒌑𒉡𒋼𒍣𒄭𒊒𒋫	MPB
𒊩𒉣𒌓𒌈	LTB
𒌅𒋡𒀀𒀪	STB
𒌨𒀊𒆤𒇲	SUX
𒀀𒈾𒁹𒄩𒀀𒄿𒋀𒅀	MPB
𒅟𒇽𒀀𒆥𒌝𒈠	NEB
𒌅𒆳𒋰	STB
𒀭𒂗𒆤𒌋𒀭𒊩𒌆𒆤𒀭𒈦𒌋𒀭𒉺𒌆	NEB
𒈨𒌍𒉡𒅇	MPB
𒅖𒌅𒀸𒊏𒉡	MPB
𒌌𒅔𒉌𒅁𒁍𒍑	NEB
𒂊𒈪𒁺𒀀𒆷𒆪	STB
𒀭𒅎𒈬𒊭𒅆𒌗𒁈𒍠𒃻𒌓𒊹	OLB
𒀭𒈨𒌍𒃲𒈨𒌍𒃻𒀭𒂊	NEB
𒇽𒋢𒋛𒅅𒍣𒂵	OLB
𒊹𒊕𒀴𒊮𒄞	OLB
𒈗𒁁𒉌𒀀𒄿𒁲𒆠𒄿	NEB
𒁹𒊏𒁍𒌓𒀭𒂗𒍪	OLB
𒅇𒀀𒃻	LTB
𒊭𒋀𒅀𒆠𒄿𒄿𒇷𒌨𒋼𒅁𒁉𒈠	MPB
𒊹𒊕𒀴	OLB
𒌉𒃻𒀀𒀸𒄷𒌓𒊮𒁉𒋙𒉡𒊹𒋗𒈫𒀸𒆠𒊒𒁀𒀀	LTB
𒌉𒌉𒉌	OLB
𒇽𒄿𒌓𒀪𒀀𒀀	NEA
𒁾𒉿𒋗𒉈𒌈𒃻𒀀𒃻𒀀𒃻𒆠	LTB
𒁹𒀭𒂗𒍪𒊺𒈪	OLB
𒄿𒆷𒆥𒌋𒉌𒄿𒊓𒄯𒊏𒁁𒄣𒋙	NEA
𒀭𒈫𒄯𒈫	SUX
𒌅𒈾𒀪𒊍	STB
𒇽𒈬𒁺𒀀𒃻𒀀𒃻𒅇𒀀𒃻	LTB
𒇽𒆠𒄿𒉿𒃻𒆳𒉏𒈠𒆠𒃻𒀸𒂍𒊹𒅎𒁉𒅀	NEB
𒉈𒂊𒈬𒊭𒊹𒀭𒀫𒌓𒀀𒀸	NEA
𒀠𒂵𒀜𒁕𒋳𒈠𒌉𒅟𒋗𒁓	MPB
𒊹𒁕𒆠𒊒𒁀𒀀𒃻𒊹𒌋𒋀𒈨𒌍𒋙𒌉𒈨𒌍𒃻𒊹	LTB
𒊹𒌓𒊹𒆚𒀀𒈾𒋻𒉡𒁺	STB
𒅟𒁀𒅈𒌈	OLB
𒌌𒇺𒁹𒌌𒇷𒄿	STB
𒄿𒋫𒁉𒌋𒀀𒈾𒇽𒀀𒈨𒊑𒅀	NEA
𒊭𒇽𒃲𒁉𒈜	NEA
𒀀𒈾𒅟𒊑𒁉	NEB
𒁹𒀭𒌓𒈾𒄴𒊏𒊑𒇽𒀊𒉣𒈾𒆠	OLB
𒊹𒈠𒈾𒀀𒀀𒊹𒄯𒁉𒍝𒍮	NEA
𒀸𒌺𒃻𒆳𒅀𒅋𒋳𒉌	NEB
𒀀𒁲𒂊𒃻𒈗𒁁𒉌𒅀	NEB
𒀭𒍣𒍣𒁕𒀭𒊩𒌆𒅁	SUX
𒀀𒁲𒉈𒇻𒅟𒌓𒈨𒌍𒌅𒋻𒇴𒈠𒌅𒄤𒍢	STB
𒅖𒈨𒌍𒀀𒈾𒅥𒋙𒉡𒆥𒊒𒀀𒈾𒋁𒋙𒉡	STB
𒆸𒁀𒈠𒊏𒋻𒂊	SUX
𒊭𒄿𒈾𒈠𒀜𒉌𒋛𒅔𒆠	OLB
𒀀𒈾𒄞𒄭𒀀𒈠𒅀𒀠𒁴	OLB
𒁀𒊑𒂵𒑏𒑏𒋡𒋡𒋡𒋡𒋡𒋡	OLB
𒁍𒄣𒌑𒁕𒂵𒇻	STB
𒑚𒈠𒈾𒅇𒊹𒂆𒉚𒄑𒊒𒁀𒈬𒈨𒌍𒇽𒋋𒌑𒌓	LTB
𒌷𒄠𒁉	MPB
𒀉𒋾𒋙𒊍𒍝𒅟	NEB
𒀀𒈾𒈗𒁁𒉌𒅀𒉌𒉺𒅁𒉺𒊏	NEA
𒊒𒈠𒌋𒃻𒀀𒋙𒌋𒅗𒄩𒋙	NEB
𒃻𒋻𒁀𒊍𒃻𒂍𒅎𒋛𒁲𒁕𒂍𒌉𒃻𒊹𒌑𒍑𒆠𒌑	LTB
𒄿𒆸𒉈𒋙𒈠𒌉𒄩𒉈𒀜𒋙𒀭𒌓𒆳𒋢𒈠	STB
𒀀𒈾𒉺𒉌𒀭𒀭𒊏𒄠𒀀𒉡𒌝	OLB
𒊭𒀭𒀝𒌋𒀭𒌨𒈨𒌈	STB
𒄀𒀕𒈾𒆬	SUX
𒀭𒈨𒌍𒅀𒀭𒌓𒅀𒀀𒈾𒌷𒋗𒊩𒆳𒋾𒋗	MPB
𒀭𒈫𒂷𒋛𒁲𒈫	SUX
𒌷𒈨𒌍𒉌𒊭𒆳𒄿𒌓𒀪𒀀𒀀	NEA
𒁹𒆪𒀭𒍂𒇽𒄭𒃻𒉆𒊑𒅕𒀖𒁍𒋙𒈠𒇻𒌋𒇧𒄩𒀀𒋾	STB
𒀀𒈾𒆪𒀸𒉿𒋼𒈠	NEA
𒀀𒈾𒆬𒌓𒀀𒈾𒊑𒄷𒄭𒌑𒌓𒀀𒈾𒉡𒂄𒉡𒌑𒀀𒈾𒆕𒌍𒀾	LTB
𒃻𒈗𒁁𒉌𒅀𒌑𒉌𒇻𒌑	NEB
𒅎𒈥𒌅𒁕𒂍𒁹𒆷𒁀𒅆𒇽𒈠𒄭𒊏𒉡𒂍𒆠𒊒𒁀𒀀𒈬𒈨𒌍𒌉𒃻𒊹	LTB
𒅇𒀀𒈾𒆪𒇻𒌑𒀜𒁷	MPB
𒊩𒁁𒀖	LTB
𒌨𒈬𒌑𒌋𒁲𒀸𒆳𒅅	STB
𒊹𒊹𒅇𒊹𒋗𒋫𒌅𒌑	STB
𒍑𒀭𒌑𒅎𒋛𒁲𒁕𒂍𒀀𒃻𒊹	LTB
𒀀𒈾𒁍𒊻𒊑𒃻𒄩𒋾𒆷𒋫𒉏𒈨𒁕	STB
𒊭𒈗𒁁𒉌𒅖𒁓𒀭𒉌𒈠𒀀𒀸𒅕𒋾	NEA
𒆷𒋫𒊭𒂵𒀭𒂵𒀸𒋫𒆪	MPB
𒆠𒋗𒈠𒄿𒈾𒀭𒈾𒀀𒈾𒅀𒀀𒅆	MPB
𒄩𒊒𒁍𒄑𒄈𒀀𒃻𒄖	STB
𒁹𒆪𒋼𒂊	OLB
𒀭𒂗𒉡𒌦𒁲𒈠𒋗	SUX
𒂊𒄯𒌋𒉌	NEA
𒁹𒀭𒊩𒌆𒋚𒀀𒁉	OLB
𒀸𒋗𒊹𒇽𒀀𒈨𒊑𒅀	NEA
𒁹𒀀𒄷𒉿𒃼	OLB
𒁹𒀭𒀫𒌅𒅆	OLB
𒀀𒈾𒊹𒂆𒆬𒌓𒄑𒋫𒌁𒊏𒉡𒃻𒁹𒀭𒋾𒀪𒄿𒆪𒋢	LTB
𒀴𒊹𒌋𒀭𒌓	MPB
𒃻𒁀𒈨𒌍𒈠𒀪𒋫𒀜𒋫𒋫𒀜𒁷𒋗𒉡𒈠	MPB
𒆷𒀀𒀀𒆗𒇷𒄖𒌦𒄭𒀀𒅀	MPB
𒆳𒂗𒅀𒄿𒅋𒆷𒂵𒄠𒈠	MPB
𒊺𒁉𒆷𒀭𒉌	NEA
𒁹𒀭𒀫𒌓𒈾𒈲	OLB
𒀸𒁍𒌅𒋗	NEA
𒀸𒄘𒃻𒋫𒋼𒀀𒊏𒌒	NEA
𒈗𒈬𒅆𒊒𒀭𒈹𒆤	SUX
𒀭𒄩𒉌𒅖𒅂𒋗𒀭𒅎	SUX
𒈠𒀀𒌑𒈠𒀀𒄑𒈪𒈗𒁁𒉌𒅀𒃻𒈨𒌍𒅟𒀀𒆰	NEA
𒁹𒀴𒀀𒅆𒅕𒋫𒀴𒌨𒂠𒅇𒆷𒆪	MPB
𒌗𒌓𒊹	OLB
𒌉𒃻𒀀𒀸𒄷𒌓𒊮𒁉𒋙𒅆𒅖𒋙𒀸𒌓𒊹	LTB
𒀭𒆪𒈨	SUX
𒁀𒀸𒋾𒀭	OLB
𒁴𒋙𒃻𒀭	STB
𒀀𒈾𒊹𒈾𒀜𒉡𒌌𒋼𒁉𒇷	NEB
𒀸𒌷𒁷𒌁𒆠𒋼𒀀𒍢	NEB
𒆷𒌑𒉿𒄴𒃶𒊒𒅟	MPB
𒅎𒁍𒁕𒄿𒊑𒁀𒄠	SUX
𒊺𒆰𒈨𒌍𒋙𒉡	NEA
𒉌𒅅𒁍𒌋	NEB
𒂍𒈬𒈨𒌍𒌋𒊹𒇽𒈬𒈥𒊩𒋡𒀭𒉡𒀀𒈾𒊹	LTB
𒅋𒋃𒌋𒉌𒄈𒈨𒌍𒇷𒆪𒆷𒋗	STB
𒀭𒊊𒈫	SUX
𒌉𒈗𒂉𒃻𒊑𒈛	SUX
𒁲𒈬𒆧𒃻𒋾	STB
𒌉𒀭𒅎𒌨𒊕	MPB
𒃷𒄘𒂔𒈾𒅟	SUX
𒃻𒁹𒀴𒌋𒄥𒋀𒋙𒊩𒋙𒀸𒂍𒅁𒋙𒆠𒁴𒆍𒃲𒀭𒌓𒃻𒆠𒆗	LTB
𒃻𒀀𒈾𒄑𒊒𒁀𒈨𒌍𒈬𒈨𒌍𒅅𒁉𒅆𒁺𒃻𒆠𒊹𒇽𒈠𒄭𒊏𒉡𒄑𒊒𒁀	LTB
𒅇𒇻𒉿𒅆𒊏𒊹𒋫𒁄𒊭𒋝𒆪	MPB
𒄑𒊒𒁀𒇽𒈬𒌑𒌓𒈬𒈨𒌍𒅅𒁉𒅆𒁺	LTB
𒁹𒁀𒃻𒀀𒌋𒌉𒈨𒌍𒃻𒊹𒌋𒈪𒋻𒌑𒊕𒆠𒀭𒋫𒅎𒈥𒌅𒁕𒆠𒊒𒁀𒀀𒃻	LTB
𒌓𒅗𒁇	MPB
𒊹𒂆𒈦𒂆𒀀𒈾𒈨𒈨𒄿𒉌	NEA
𒀀𒇉𒄩𒄠𒈬𒊏𒁉𒃶𒅅	SUX
𒀀𒋩𒊒𒊏𒊹𒄑𒇀𒈨𒌍	NEA
𒊏𒁉𒀀𒉡𒌝𒌷𒀀𒊬𒈬𒌝𒆠	OLB
𒀸𒌋𒅗𒇽𒃲𒌷𒈨𒌍𒊭𒂍𒌦𒆥𒀀𒀀	NEA
𒂍𒌾𒆠𒅟𒉌	SUX
𒌑𒀀𒀀𒌒𒆬𒌓𒉡𒍝𒁍	STB
𒈗𒁁𒉌𒉿𒅋𒆪	NEA
𒀠𒋰𒆜𒋙𒌋𒀀𒁺𒌑	NEB
𒍜𒈨𒌍𒆪𒉡𒍜𒈨𒌍𒃻𒋀𒈨𒌍𒆪𒉡𒌉𒈨𒌍𒆪𒉡	STB
𒌑𒉆𒈬𒋙	NEA
𒂕𒊏𒀭𒂗𒍪	SUX
𒈾𒁲𒅔	OLB
𒈠𒆷𒋫𒋆𒈬𒌑	NEB
𒃷𒃷𒃷𒀀𒊮𒈦𒄘𒃼	SUX
𒉌𒆤𒋾𒋗𒉡	NEB
𒄿𒈾𒉈𒋼𒈨𒌍𒌷𒍮𒈬𒊑𒆠	MPB
𒌅𒍝𒀭𒅘	STB
𒆠𒈠𒌓𒍣𒊭𒀀𒀀𒁍𒋾𒅟	MPB
𒀜𒋫𒁷𒌉𒈨𒌍𒅀	MPB
𒌉𒀀𒁲	OLB
𒊹𒑛𒌑𒍑𒆠𒌑𒅎𒆳𒊏𒁕𒀀𒈠𒀾𒌈𒃻𒁉𒈩𒋙𒉡𒊹𒌑𒊕𒆠𒀭𒋫𒅎𒋛𒁲𒁕	LTB
𒌷𒉆𒊩𒌆𒀀𒅟𒈾	SUX
𒀉𒁷𒌋𒉌	NEA
𒅆𒆷𒅋𒋃	NEA
𒁹𒌋𒅗𒄭𒌋𒊩𒀀𒆳𒀭𒋗𒊩𒇽𒌓𒁴𒈬𒈨𒌍	LTB
𒀀𒉡𒌝𒈠𒊹𒇽𒀴𒈨𒌍	MPB
𒄩𒀭𒁹	NEB
𒊭𒋢𒆬𒄀𒊭𒀝𒉡	STB
𒄿𒈾𒁹𒋫𒀀𒄀	MPB
𒈾𒆕𒀀𒄰	SUX
𒁹𒀴𒀀𒁲𒋙𒌋𒊹𒌉𒈨𒌍𒃻𒊹𒇽𒊏𒁉𒂍𒄭𒇷𒄑	LTB
𒀀𒈾𒆪𒅇𒋗𒌑𒌓𒉌𒅋𒆷𒀝	MPB
𒆠𒄯𒊏	SUX
𒊹𒌑𒊕𒆠𒈨𒌍𒉺𒌈𒂍𒆠𒊒𒁀𒀀𒈬𒈨𒌍𒂍𒆠𒊒𒁀𒀀𒈬𒈨𒌍	LTB
𒇽𒈬𒋾𒀀𒁄𒆠	OLB
𒀭𒈨𒌍𒆳𒆳𒀸𒅆𒅆𒌑𒌑𒋡𒌅	STB
𒉺𒉡𒆏𒁉𒀀𒈾𒅀𒅆𒅇𒊹𒇽	MPB
𒁀𒊑𒂵𒍥𒍑	OLB
𒀭𒊩𒌆𒄈𒍪𒅟𒆕𒀀	SUX
𒉌𒌓𒅆𒈬	SUX
𒋾𒅖𒋾𒈪𒅖𒌅𒀸𒊏𒉡𒌝	MPB
𒀀𒃻𒀀𒃻𒀀𒀸𒅖𒆠𒃻𒁹𒀭𒌓𒈬𒉡𒇽𒀜𒋙𒉡𒀸𒂍𒈨𒌍𒌈𒋙𒌑𒌓	LTB
𒌋𒁹𒀭𒈾𒈾𒀀𒆚	LTB
𒁹𒈗𒊑𒂗𒅀𒀭𒅀𒀭𒌓𒅀	MPB
𒆷𒆥𒌷𒍮𒈬𒊑𒁹𒀀𒍣𒊒	MPB
𒀭𒀀𒂷𒈪𒉭𒅗𒂵𒁁𒂗𒉡	SUX
𒌉𒂍𒁾𒁀	OLB
𒀸𒌋𒅗𒌦𒈨𒌍𒂍	NEA
𒇽𒂗𒉆𒊭𒌷𒌀𒇷𒅀	NEA
𒁹𒇷𒁉𒀉𒀹𒁯𒇽𒊭𒅖𒌅𒈬𒋾𒀀𒁀𒇻𒌝𒆠	OLB
𒋧𒈠𒀀𒈾𒆪𒀸𒌷𒀀𒈨𒌍𒄙𒈾	NEA
𒀭𒂊𒉡𒊌𒆠𒀭𒀀𒉣𒈾𒆠	STB
𒂙𒆳𒋛𒁲𒊩𒉽𒈨𒌍𒅅𒈨𒌍	STB
𒊹𒊹𒆜𒋙𒉽𒈠𒌋𒌋𒌓𒈠𒁺𒀝	STB
𒀭𒆠𒄖𒆷𒋗	SUX
𒅆𒊹𒌋𒌋𒉡𒅟𒋛𒀪	NEA
𒊒𒄷𒌋	MPB
𒉺𒉿𒊏𒀀𒍣𒊒	MPB
𒀀𒈾𒀀𒉿𒋼𒈨𒌍𒈗	MPB
𒄿𒉺𒆤𒀸𒌋𒅗	NEA
𒊹𒊹𒀸𒀀𒆷𒆠𒋙𒌓𒈭𒄩𒊍	STB
𒌗𒍩𒆚𒌓𒊹𒈬𒊹	LTB
𒂍𒈦𒈗	OLB
𒄥𒄥𒍥𒍑𒀀𒈾𒆠𒁉𒃻	OLB
𒈠𒀀𒄿𒊓𒈾𒇷	NEA
𒇽𒁾𒊬𒃻𒊹	NEB
𒀾𒋙𒉈𒂊𒈬𒃻𒁷𒌁𒆠	NEB
𒀭𒌓𒋫	SUX
𒊹𒀸𒋗𒈫𒊹𒌉𒃻𒁹𒋺𒆗𒉡𒈠𒆟𒀪𒂊𒋩𒀪	LTB
𒀭𒌨𒁀𒌈𒁮𒁉𒊩	STB
𒊹𒇽𒈾𒁷𒈾𒀭𒂍𒈬𒈨𒌍𒌋𒀀𒋙	LTB
𒌷𒈨𒌍𒄩𒍝𒉡𒋾𒈗𒀀𒈾𒊭𒋗𒉡	MPB
𒊭𒀸𒌷𒁲𒈦𒋡𒊭𒀸𒅆𒈗𒂗𒅀	NEA
𒋾𒅁𒇽𒉽	STB
𒌑𒊒𒁀𒀀𒋾𒅅𒈨𒌍	STB
𒈲𒅆𒌨𒁁𒈪𒀉𒌈𒀸𒂍𒈾𒅆𒂗𒂍𒌀	STB
𒌅𒆸𒉽	STB
𒁕𒋻𒋗𒈫𒉡𒈬𒋳𒌦𒈨𒌍𒈨𒌍𒉺𒃻𒉌𒌈𒃻𒆠𒊒𒁀𒀀𒃻𒂍𒈬𒈨𒌍𒊹𒌑𒍑𒀭𒌑𒅎𒋛𒁲	LTB
𒁹𒀭𒈾𒈾𒆰𒆕	LTB
𒀭𒈗𒀫𒁕𒃻𒀫𒁕𒆠	NEB
𒌉𒃻𒁹𒀭	LTB
𒅁𒇲𒌈	SUX
𒊹𒌋𒊹𒌉𒈨𒌍𒃻𒀀	LTB
𒃻𒉽𒉽𒉽𒉽𒈾	SUX
𒀲𒊺𒉻𒈨𒌍𒇽𒂗𒉆	NEA
𒊹𒀸𒈨𒀸𒆠𒁺𒊹𒁺	STB
𒊹𒀀𒁺𒉡𒅖𒆪𒋾𒇽	NEA
𒀸𒋗𒈫𒀀𒃻𒈠𒆟𒈨𒌍𒂊𒋩𒈨𒌍	LTB
𒀀𒁺𒊹𒅆𒋙𒀀𒈾𒈗𒂗𒅀	NEA
𒊹𒀀𒊹𒊹𒌉𒃻𒊹𒀀𒁹𒇻𒍑𒌓𒈥𒀭𒅎	LTB
𒌋𒅗𒅀𒈨𒅀𒈪	MPB
𒆷𒋼𒀉𒋾𒅅	NEB
𒊹𒌋𒊹𒄠𒋻𒇷𒄿𒋼𒈗𒁁𒇷𒅀	MPB
𒀭𒀸𒋩𒀭𒊹𒀭𒌓	NEA
𒃻𒀸𒌋𒅗𒄭𒌷𒄯𒈠𒋗	NEB
𒀭𒀭𒈾𒊬𒋥𒂍𒀭𒈾	SUX
𒄿𒊑𒁀𒄠𒀭𒂗𒍪	OLB
𒅇𒌷𒁮𒆠𒉌𒉌𒋗	OLB
𒄩𒍝𒉡𒌈𒆷𒀀𒈾𒀜𒉡	MPB
𒅇𒀀𒉡𒌝𒈠𒊭𒀀𒊑𒈗	MPB
𒀸𒊮𒁉𒄩𒊏𒂵𒋾𒀸𒆪𒌌𒋼𒈪𒉈𒊬𒄴	STB
𒊮𒊑𒁺𒌓𒊭𒌓	OLB
𒌉𒇽𒀊𒉣𒈾𒆠	OLB
𒂊𒌀𒅗𒀭𒌓	OLB
𒊹𒊕𒊩𒆳𒀴𒊭𒀭𒄩𒍣𒅕𒉺𒋼𒋛𒀭𒌓	OLB
𒃾𒄭𒀀𒄷𒍝𒈾𒀀𒌓𒅇𒀸𒆬𒌓𒃻𒀀𒈾𒋫𒄠𒂇𒊏𒀀𒌓	LTB
𒀭𒁮𒁉𒊩	SUX
𒉺𒄿𒆷	OLB
𒍝𒀀𒌓𒋺𒋫𒁷𒆬𒌓𒀀𒀭𒑚𒈠𒈾𒉚𒄑𒊒𒁀𒈬𒈨𒌍	LTB
𒉺𒈥𒌅𒈨𒌍𒇽𒄖𒋾𒌝𒆠	OLB
𒍑𒀭𒌑𒅎𒋛𒁲𒍑𒊓𒁺𒈗𒃻𒀀𒈾𒌑𒆗𒉡𒊑𒋃𒊹	LTB
𒋗𒁀𒋾𒀀	SUX
𒌗𒀊𒌓𒁺𒀀𒌓𒊹	OLB
𒀀𒈾𒀜𒅀𒇻𒌑	NEB
𒅖𒁓𒀭𒉌𒉌	NEA
𒄑𒄖𒍝𒁳𒂍𒀭𒈨𒌍	STB
𒊹𒉺𒇻𒍚𒅊𒅊𒀭𒂗𒆤𒇲𒆤	SUX
𒌉𒃻𒊹𒈦𒌑𒍑𒊕𒆠𒀭𒋫𒅎𒈥𒌅𒁕𒂍𒊹𒌋𒁮𒋙	LTB
𒅆𒅅𒌅	STB
𒄿𒈾𒇽𒉺𒁼𒅆𒁹𒅀𒀭𒄩𒈠	MPB
𒉆𒄩𒅈𒋾𒀭𒂗𒍪𒁁𒂖𒉌𒉌	OLB
𒌝𒈠𒊩𒄩𒁲𒌓𒀸𒆍𒂍𒇽𒁲𒋻	NEB
𒀀𒈾𒊹𒌓𒈬𒃻𒌑𒊺𒋾𒅅𒀸𒋗𒈫𒊹𒈬𒈨𒌍	LTB
𒌦𒈠𒈫	SUX
𒊭𒆪𒌑𒃻𒁺𒌑	STB
𒀀𒈾𒉺𒉌𒈗𒂗𒅀𒄿𒊕𒅟𒉡	NEB
𒌌𒅖𒈬𒋙𒉡𒌓	NEB
𒀀𒄯𒈪	MPB
𒉌𒋻𒁺𒀀	SUX
𒀀𒁲𒋫𒊑𒄿𒋾	MPB
𒅇𒀠𒇻𒌑𒈨𒇽𒈨𒌍𒉺𒁼𒈨𒌍	MPB
𒂗𒅀𒌨𒊒𒁍𒆜𒊹𒉺𒉌𒌑	NEA
𒂗𒀭𒈩𒋃𒀕𒆠	SUX
𒇽𒌉𒆗	NEA
𒉡𒉽𒌈𒁕𒀭𒈾𒀜	MPB
𒅖𒇯𒋺	SUX
𒀀𒇲𒇻𒌑𒈾𒀭𒍝𒁍𒃻𒄀	STB
𒀀𒈾𒁹𒉌𒅎𒈬𒊑𒅀𒈗𒃲	MPB
𒆳𒅀𒁲𒌍𒅇	MPB
𒀀𒃻𒀀𒀀𒈾𒌓𒈬𒍝𒀀𒌓𒀉𒋺𒁷𒆬𒌓𒀀𒀭	LTB
𒅇𒄿𒉡𒈠𒅔𒉌𒊑𒅕𒀀𒈾𒆪𒈪	MPB
𒀲𒀀𒀊𒁀𒈨𒌍	NEB
𒀀𒈾𒂍𒁓𒊕	OLB
𒀀𒈾𒆪𒉌𒈠𒆷𒄿𒋛𒆥	NEA
𒈠𒀀𒆠𒄿𒀲𒆳𒊏𒈨𒌍𒅇𒆪𒁷	NEA
𒁹𒌨𒀭𒊩𒌆𒌅𒆤	SUX
𒀀𒃻𒀀𒈾𒌓𒈬𒍝𒀀𒌓𒈾𒋗𒌑𒄑𒊒𒁀𒈬𒈨𒌍	LTB
𒍪𒌑𒍣𒈠	MPB
𒀀𒊬𒀾𒁍𒀪𒈠𒀀𒁺𒁀𒉌𒈠	NEB
𒀀𒈾𒋆𒋾𒇷𒋆𒋙𒀭𒊩𒌆𒆤𒌝𒈬𒃲𒌅𒃻𒆠𒂍𒊓𒄿𒈾𒂍𒆳	STB
𒍣𒂵𒊮𒂍𒅆𒁾	OLB
𒉿𒀭𒆠𒋗𒇽𒊭𒉡𒀀𒈾𒊭𒋗	MPB
𒀸𒃮𒋛𒌷𒄿𒌅𒄣𒌓	NEA
𒈠𒀩𒆷𒀀𒉡	STB
𒀯𒀀𒄷𒌑	STB
𒉿𒄿𒀭𒉌𒄿	NEB
𒊹𒈬𒈨𒌍𒊹𒌑𒍑𒀭𒌑𒅎𒈥𒌅𒈨𒌍𒉺𒅆𒌈𒃻𒂍𒈬𒈨𒌍𒊹𒌑𒍑𒆠𒌑	LTB
𒀸𒀸𒀸𒀸𒀸𒀸𒀸𒊮𒊷	SUX
𒀀𒈾𒌋𒅗𒊩𒊑𒀪𒅔𒁺	NEB
𒊹𒌓𒊹𒆚𒊹𒌋𒊹𒀉𒋾𒀀𒄩𒈨𒌍	STB
𒄯𒁺𒀭𒅎𒊭𒆸𒈨	SUX
𒉺𒈥𒌅𒈨𒌍𒇽𒆠𒋩𒊏	OLB
𒌅𒂷𒆷	STB
𒄷𒍝𒈝𒊹𒌉𒊏𒌅𒄢𒋾	OLB
𒉈𒁕𒀊𒋫𒆷𒋡𒌁𒋫𒋫𒊹𒊏𒀊𒉈𒌌𒌅𒊮𒅆𒈨𒌍𒆠𒄿𒌓𒁺𒈨𒌍𒀀	STB
𒈜𒁉𒆏𒁀	STB
𒂍𒀭𒈾𒁺𒂊	SUX
𒅖𒆪𒌦𒀭𒂗𒍪	SUX
𒉡𒉽𒋫𒌋𒅗𒅀𒅇𒍝𒀊𒌅𒈪	MPB
𒇽𒈬𒈥𒊩𒀭𒉻𒄭𒀀	LTB
𒊩𒌉𒄿𒋫𒉿𒅕𒌉𒊩𒀀𒉌	OLB
𒇽𒋻𒋫𒉡𒈠𒀀	NEA
𒄑𒅅𒈪𒌷𒍝	SUX
𒀭𒈩𒇴𒋫𒌓𒁺𒋗	SUX
𒊺𒆰𒈬𒈨𒌍𒃮𒁉𒅇𒊩𒋙𒀸𒄩𒀭𒋙𒀸𒋗𒁁𒌷𒂍𒁹𒍝𒁍𒉡𒃻𒌉𒃻	LTB
𒀉𒆗𒉡𒈨𒌍𒆬𒌓𒀀𒀭𒊹𒂆𒉚𒄑𒊒𒁀𒇽𒆭𒂍𒌑𒌓	LTB
𒀀𒈾𒌒𒊑𒄊𒁉𒈗𒂗𒅀	MPB
𒃻𒋗𒊹𒉺𒀀𒋛𒊑	OLB
𒊩𒈾𒈾𒀀	STB
𒅆𒅖𒁍𒊏𒀭𒈾𒅆	NEB
𒊹𒀯𒀭𒈾𒈨𒌍𒄩𒅎𒈽	STB
𒄿𒈾𒅋𒋼𒂗𒊺𒂊𒊑𒄿𒀭𒁉𒂊𒂖𒌑𒊑𒄿𒈾𒅆𒄿𒅔𒊺𒂊𒊑𒄿	STB
𒊹𒀭𒌈𒀭𒂗𒆤𒀭𒅂𒊹𒀭𒌓𒀭𒅎𒀭𒀫𒌓𒀭𒉽𒈛	LTB
𒃻𒌗𒊻𒋢𒆗𒈬𒀭𒈾𒄖𒊌𒋡𒉌𒂊𒌓𒀊𒀊𒅇𒊩𒈠𒃮𒁉	LTB
𒊹𒃻𒌓𒈬𒀸𒌓𒊹𒌓𒊹𒅇𒌓𒊹𒉽𒅆𒅔𒍣𒊒𒌑𒃻𒊹𒌓𒈬	LTB
𒌅𒈠𒍝𒊍	STB
𒈨𒀭𒉌𒂠	SUX
𒈗𒃶𒀀	SUX
𒌋𒌉𒈨𒌍𒃻𒀀𒌋𒌉𒈨𒌍𒃻	LTB
𒁹𒅔𒊩𒌆𒂗𒋙𒉡	LTB
𒀀𒈾𒁹𒀀𒍣𒊑𒉿𒁍𒍑𒅁𒊭𒃲	MPB
𒋗𒊭𒅆	SUX
𒌉𒈾𒁉𒀭	OLB
𒑛𒊺𒀀𒊮𒊹	SUX
𒁹𒀭𒀫𒌓𒈾𒍢𒅕	OLB
𒋗𒊹𒀀𒀀𒈾	NEB
𒌌𒌅𒌋𒅗𒃻𒂗𒈗𒈨	NEB
𒇽𒃻𒌌𒂊𒉺𒌓𒁺𒀀𒀀𒀭	SUX
𒊮𒊹𒇽𒍑𒁇𒈨𒌍	OLB
𒀝𒄭𒁀𒀾𒋙𒉡𒊌	NEA
𒂍𒐐𒀭𒅎𒈪𒄷𒌓𒌓𒊏𒉌	SUX
𒌉𒃻𒈤𒊒𒀪𒂊𒋩𒀪𒌓𒈬𒉺𒋡𒊑𒁹𒌋𒅗𒄭	LTB
𒊹𒌉𒊩𒃮	OLB
𒁹𒀴𒀀𒅆𒅕𒋾𒅇𒀀𒉡𒈠𒄿𒈾𒀭𒈾	MPB
𒋀𒈨𒌍𒋙𒉡𒀀𒈾𒉺𒉌𒉌	NEB
𒊹𒈠𒃼𒊏𒀀𒋾𒊭𒆪𒉿𒂊	NEA
𒀸𒌋𒅗𒄭𒊹𒈾𒋛𒁇𒇽𒃲𒌷𒈨𒌍	NEA
𒍑𒆠𒌑𒅎𒍇𒇻𒁕𒆠𒊒𒁀𒀀𒃻𒅇	LTB
𒀸𒌗𒁈𒅆𒁾𒊩𒅆𒂟𒃻𒋙	STB
𒌓𒈿𒀀𒀭𒀀𒁍𒁍𒆷𒈤𒊒𒌌𒌓𒆠𒁴	STB
𒌑𒈦𒊬𒀭𒉌	NEB
𒇽𒂗𒉿𒆤𒋾𒃻𒈗	NEB
𒁹𒀀𒉿𒅋𒀭𒈾𒁉𒌝	OLB
𒂟𒈨𒌍𒌀𒆷𒁴𒀀𒈾𒈾𒍝𒊑	MPB
𒊹𒅀𒁲𒀪𒄿𒇻𒈬𒋙𒄴𒋾𒌨𒀸𒌋𒅗	NEA
𒁹𒆪𒌒𒁍𒌈	OLB
𒅆𒌓𒂊𒋾𒉌	NEB
𒃻𒊹𒆰𒆤𒋾𒋛𒁲𒀀𒈾𒌋𒅗	NEB
𒈪𒄿𒈾𒄠𒈠𒋼𒊑𒅆𒅔𒉌𒅖𒌅𒅈𒄩𒉌𒌌𒇻𒋾	STB
𒉆𒄩𒅈𒋾𒁹𒀀𒁉𒆠𒈠𒀭𒌓𒈠𒍝𒊍𒆍𒁺𒃮	OLB
𒀸𒀭𒁷𒁍𒌓𒀀𒄩𒈩𒀀𒈾𒈬𒊒𒄣𒀀𒈾𒌓𒈬𒍝𒀀𒌓𒈾𒋙𒌑𒊹𒋗𒈫𒈨𒌍𒅇	LTB
𒅈𒈨𒌍	OLB
𒊭𒁁𒉌𒅖𒁓𒀀𒉌	NEA
𒊩𒌉𒀀𒇷𒁓𒌉𒊩𒉌	OLB
𒂍𒋼𒈨𒂗𒀭𒆠	SUX
𒅇𒀭𒌓𒂵𒅖	OLB
𒈬𒊹𒁹𒀭𒋾𒀪𒆪𒋢𒈗	LTB
𒀀𒀠𒋃𒆠𒄿𒁷𒌁𒆠𒂗𒈗𒈨𒌍𒅁𒁍𒋗𒆳𒌵𒆠	NEB
𒀀𒁲𒉿𒌑𒌌𒆪𒁹𒀀𒍝𒊒𒆠𒈠𒀀𒁉𒋗	MPB
𒌨𒋫𒄠𒈨𒄿	NEA
𒅁𒁄𒇷𒋢𒈠	STB
𒑏𒑏𒊺𒊹	SUX
𒊕𒆠𒆠𒋫𒅎𒆳𒊏𒁕𒋻𒁀𒊍𒃻𒁉𒈩𒌋𒊹𒋀𒋙𒈨𒌍𒉺𒃻𒉌𒌈	LTB
𒁲𒈥𒆠	STB
𒅖𒁍𒊏𒌝𒈠	NEB
𒇷𒊩𒁉𒊒𒁄𒌑𒅟𒄠𒈨𒉌𒊹𒂗𒋙𒊹𒋙	NEB
𒀭𒀫𒌓	STB
𒅁𒉌𒀭𒈥𒌅	SUX
𒅇𒊹𒇽𒄵𒋫𒀀𒀀𒀴𒈨𒌍𒃻𒈗	NEB
𒅇𒀜𒆷𒆪𒆏𒁍𒆪𒉡𒅇𒀭𒉡𒌑𒄭𒂵	MPB
𒀭𒋛𒁲𒌦𒈠𒋗	SUX
𒊓𒄠𒌈𒊭𒀭𒂗𒍪𒅁𒉌𒋗𒉺𒂆𒍑𒈨𒌍𒅋𒇷𒆠𒀀𒄠	OLB
𒄿𒋡𒁍𒌋𒌋𒋙𒀭𒂍𒀭𒀀𒀀𒀝𒋫𒃻𒁕	NEA
𒀀𒃻𒀀	LTB
𒅟𒁉𒂍𒈦	SUX
𒌌𒅖𒁓𒀭𒈾𒅆	NEB
𒁍𒈝𒆳𒌵𒆠𒌓𒂵𒌋𒌋𒀸𒂔	STB
𒀭𒌓𒅀𒊹𒊹𒄠𒋻	MPB
𒁹𒆠𒁷𒇽𒀴𒋢𒃻𒋗𒈫𒊹𒀀𒈾𒈬𒃻	LTB
𒌓𒁉𒀀	SUX
𒀀𒉺𒅁𒉺𒊏𒅇𒆠𒄿𒆷𒌓𒌁𒊒	NEB
𒀀𒉈𒀭𒈥𒌅	OLB
𒊒𒌒𒃮𒁉𒇽	NEB
𒁹𒀭𒌓𒆷𒈠𒍣	OLB
𒌷𒂍𒅎𒁉𒐊	NEB
𒊹𒀯𒀯𒀯𒅟𒈲𒉌𒅥𒂊𒆳𒌓	STB
𒀀𒁺𒅈	NEA
𒆏𒍪𒍪𒊭𒀭𒅎𒈠𒌨	MPB
𒃻𒈗𒁁𒉌𒅀𒌑𒉌𒇷	NEB
𒀀𒈾𒊭𒋗𒉡𒅖𒌅𒌷𒊩𒌆𒅁	MPB
𒀀𒈾𒀭	OLB
𒉌𒌓𒌋𒍏𒄭𒀀	STB
𒊹𒊕𒀸𒊹𒊩𒋗𒄀𒊹𒊮𒀜𒊹𒊩𒌉𒊹𒌉	OLB
𒁹𒀀𒄩𒄠𒉪𒅆	OLB
𒃻𒌓𒈬𒀸𒊹𒌓𒈬𒀸𒈪𒋻𒀸𒌓𒊹𒌓𒊹𒌓𒊹𒌓𒊹	LTB
𒈠𒀝𒊑𒌈𒆷𒋡𒁉𒌈	STB
𒍪𒁲𒂊𒉡𒌫𒀭𒆏𒋫	OLB
𒁹𒉌𒉌𒁴𒀭𒀫𒌓	OLB
𒅟𒀀𒀀𒈠𒉡𒁲𒅁𒁉𒄭𒂵𒈨𒌍	NEA
𒌋𒀀𒁲𒂗𒈾	NEB
𒐴𒌋𒌋𒌋𒌋𒌋𒌋𒃷𒀀𒊮𒊹	SUX
𒆷𒀀𒋡𒊑𒁉	NEA
𒃻𒌓𒈬𒀸𒌓𒊹𒊩𒋙𒃻𒌓𒈬𒀸𒌓𒊹𒅆𒅖𒋙𒃻𒌓𒈬	LTB
𒁉𒌑𒋫𒈨𒁕	NEA
𒆠𒈠𒊭𒋡𒁉𒋗	MPB
𒈦𒈠𒋗𒌋	MPB
𒊹𒇽𒆠𒋩𒊏𒆠	OLB
𒊭𒅖𒌅𒃻𒊕𒅋𒇷𒆠𒀀𒄠	OLB
𒅋𒋰𒊏𒂗𒈾	NEB
𒁁𒋾𒁁𒋾𒅀𒀀𒈾𒈗𒆳𒉏𒈠𒆠	NEA
𒊹𒀭𒊹𒀭𒌓𒅅𒋗𒁮𒈠𒆠𒋙	STB
𒁹𒊏𒄿𒅎𒆠𒁴	OLB
𒌑𒋼𒅕𒊒𒉌𒅖𒋗𒉡𒋾	OLB
𒊩𒌆𒌉𒆠𒉘𒀭𒆬𒂵𒆤	SUX
𒋗𒌑𒈗𒁁𒉌	NEA
𒀀𒈾𒊮𒁉𒊑𒋃𒈠𒉌𒊏𒄴𒄷𒊻	NEB
𒅇𒀀𒈾𒈬𒄭𒁹𒀀𒈠𒀭𒄩𒀜𒁉	MPB
𒍑𒊹𒌑𒊕𒆠𒈪𒋚𒌈𒆠𒊒𒁀𒀀𒈬𒈨𒌍𒈪𒋻𒀸𒆠𒊒𒁀𒀀	LTB
𒊹𒀀𒁹𒂠𒍪𒌑	LTB
𒌦𒄗𒀀𒁉𒈪𒉌𒅁𒄄	SUX
𒊹𒊕𒊩𒆳𒀀𒈾𒊩𒍑𒁇𒈨𒌍	OLB
𒁹𒈗𒊑𒂗𒅀𒀀𒉡𒈠𒁹𒅀𒀭𒄩𒈬	MPB
𒂍𒇽𒌝𒈠𒉡𒅎	LTB
𒂍𒈤𒉌𒀀𒈬𒈾𒉌𒆭	SUX
𒀴𒀭𒌓	OLB
𒀸𒋳𒆸	MPB
𒀝𒆷𒀸𒁍𒁍𒌋𒋾𒄷𒋚𒄭	STB
𒃻𒌋𒌋𒍝𒀜𒁺𒉡𒌫𒊕𒈠𒋫𒀀𒋾𒀸𒀭	STB
𒊭𒄿𒆏𒁉𒈗𒂗𒅀	MPB
𒊭𒀀𒈾𒆍𒀭𒊏𒆠	NEA
𒁷𒌁𒆠𒌋𒁈𒉺𒇻𒆠𒂄𒅆	NEB
𒅖𒁍𒊏𒄿𒈾𒁷𒌁𒆠	NEB
𒌓𒌍𒌍𒈨𒌍𒌋𒊩𒈠𒃮𒁉𒃻𒀀𒈾𒄑𒊒𒁀𒇽𒄊𒋧𒂵𒌑𒌓𒈬𒈨𒌍	LTB
𒍜𒄯𒈨𒌍𒍜𒊑𒋡𒀀𒌓𒅇𒑏𒑏𒑏𒑏𒊹𒋡𒌋𒊹𒋗𒈫𒈨𒌍𒃻𒊹𒋡𒊩𒈠𒃻𒀀𒈾	LTB
𒀀𒈾𒌋𒅗𒄭𒉡𒆷𒄿𒋆𒈪	NEB
𒈗𒆳𒀸𒋩𒆠𒀀𒈾𒌋𒅗𒄭𒆪𒉡𒌌𒄿𒊩𒆳	NEB
𒆠𒊭𒁲𒅀	MPB
𒌦𒈨𒌍𒄿𒄵𒊏𒀀𒌷𒋀𒋾𒀭𒃻𒂵𒋙𒌓𒁺	STB
𒌑𒋗𒍝𒅟𒀀𒆳𒌅𒌑	NEB
𒀀𒄥𒊑𒀭𒋫𒉌𒆍	STB
𒀭𒊩𒌆𒄈𒋢𒅟𒉆𒉪𒅅𒉌	SUX
𒁹𒉌𒉌𒁕𒅀𒉌	OLB
𒇷𒄯𒌋𒈜𒆤𒌋𒀀𒈾	NEB
𒀀𒈾𒌋𒅗𒊹𒀭𒀝𒋗𒊹𒍝𒁁𒌋𒊹𒀭𒌓𒃻	NEB
𒌑𒊭𒊑𒀀𒄠	OLB
𒀭𒅟𒉌𒋩𒊏	SUX
𒀭𒌓𒀸𒊮𒋙𒁺𒄑	STB
𒊭𒊹𒀾𒉺𒁀𒊑𒋗𒉡𒆠𒄿	NEA
𒊹𒀭𒉺𒌆𒌋𒌋𒉽𒌑𒊩𒇴	NEA
𒄿𒃮𒁉	NEB
𒀭𒆪𒋗	SUX
𒊒𒌑𒉌	NEB
𒀭𒈨𒈨𒀭𒊩𒌆𒋼𒀀𒊏𒀝	SUX
𒌑𒋗𒊑𒀀𒋗𒉡𒋾	OLB
𒈽𒈠𒍝𒈬	SUX
𒆳𒄭𒀀𒋗𒅇𒆷𒀀𒋾𒅅𒋗𒁺𒈾	MPB
𒀀𒈾𒅀𒅆𒄿𒈾𒌓𒈪𒅇𒌓𒈪	MPB
𒅇𒇷𒄿𒋼𒂗𒅀𒄿𒉡𒈠	MPB
𒇻𒊻𒋛𒅅𒈠	NEB
𒇻𒄭𒀀𒈨𒌍𒊭𒋫𒆳𒋫𒁀𒇷	NEA
𒌓𒈿𒀀𒀭𒈪𒌑𒆗𒇴𒅟𒌌𒌅𒌓𒈿𒃻𒌗𒃶	STB
𒉌𒈨𒆠𒋙𒉡𒁄𒆪𒅇	STB
𒁹𒍣𒋫𒈾	MPB
𒍑𒆠𒋫𒅎𒍇𒇻𒍑𒊓𒁺𒊺𒆰𒃻𒂵𒊹𒂍𒈩𒌈𒃻𒁹𒁲	LTB
𒀭𒅋𒆷𒉄𒋗	SUX
𒁹𒂍𒈾𒌑𒊺𒊑𒅁	STB
𒁹𒀭𒌓𒈬𒊭𒅆	OLB
𒄩𒁀𒇻𒈠𒅇𒆷𒀀	MPB
𒀭𒌓𒊭𒅖𒌅𒀭𒊓𒈨	MPB
𒆬𒋗𒁀𒀭𒋾	SUX
𒊕𒆠𒀭𒋫𒅎𒈥𒌅𒁕𒂍𒀀𒃻𒌋𒁕𒆠𒊒𒁀	LTB
𒌋𒊏𒁉𒋾𒄿𒁍𒍑𒈠	NEB
𒊭𒀭𒀫𒌓𒈨𒌍	OLB
𒌀𒈠𒀀𒌓𒌉𒈨𒌍𒂍𒇽𒉽𒈠𒂍𒄿𒁁𒂖𒌉𒈨𒌍𒂍𒇽𒉽𒈠	STB
𒀀𒈾𒅀𒅆𒅇𒈾𒁕𒀭	MPB
𒀴𒀭𒀝𒌋𒀭𒊺𒉀𒌋𒀭𒀀𒀀	MPB
𒅕𒊑𒋙𒉡𒋫𒄊𒊹𒈨𒌍𒋙𒉡𒋼𒀀𒆪𒌋𒉌	STB
𒅋𒋰𒊒𒈠𒇽	NEB
𒀭𒈨𒌍𒈠𒆷𒈬𒉈𒉈𒍠𒊒	NEB
𒁹𒈬𒊒𒄣𒊹𒇽𒈾𒁷𒂍𒈬𒈨𒌍𒀀𒃻	LTB
𒁹𒉌𒉌𒌝𒈠𒋾	OLB
𒁈𒉺𒇻𒆠	NEB
𒀀𒈾𒉻𒂍	OLB
𒅖𒆪𒀸𒃮𒇲	STB
𒁍𒁕𒈨𒌍𒃻𒂅𒌒𒊮𒁉	NEB
𒆠𒄿𒄴𒇷𒄣𒀀𒈾	NEB
𒅇𒀀𒈾𒆪	MPB
𒁹𒀭𒌓𒀀𒁉	OLB
𒁹𒀀𒉌𒉿𒀝𒀸	OLB
𒌅𒅟𒀀𒆷	STB
𒊑𒅅𒋢𒀀𒄖𒌑	STB
𒉆𒄩𒅈𒋾𒀹𒁯𒀭𒍝𒁴	OLB
𒈗𒂗𒐊𒀀𒋡𒁉𒁕𒁀𒀊𒋙𒀸𒊮𒁉𒊻𒉌𒅀𒋗𒌋𒀀𒈾𒆪𒉺𒉌𒊭𒈗𒂗𒅀𒆷𒀀𒄯	NEA
𒁹𒁀𒆷𒂅𒀭𒌑𒅎𒋛𒁲𒁕𒂍𒁹𒀭𒈾𒈾𒀀𒈬𒌋𒋀𒈨𒌍𒋙𒌉𒃻𒊹	LTB
𒄑𒇀𒈨𒌍𒋗𒈠𒀀𒁺𒄿𒈾𒆳𒌋𒅗𒁴	MPB
𒀭𒊩𒆳𒇯𒆬𒂵𒌉𒊩𒀭𒂗𒉡𒄀𒆤	SUX
𒃻𒉌𒌓𒈪𒅀𒈪𒋗𒌓𒄿𒉡𒈠𒀭𒆠	MPB
𒀀𒍮𒌑𒋙𒀭𒀭𒊹𒁁𒀖𒉠𒌋𒀞	STB
𒇽𒈬𒁺𒌉𒃻𒀀𒃻	LTB
𒀀𒈾𒁹𒇽𒃲𒂗𒅀	MPB
𒅇𒀀𒄯𒈨𒁹𒉆𒅀𒉿𒍝	MPB
𒆗𒉌𒉌	SUX
𒀴𒈨𒌍𒈗𒊑	MPB
𒀭𒌅𒆳𒆸𒀭𒌓	SUX
𒀭𒊩𒌆𒅇	SUX
𒀸𒊮𒁉𒊩𒌨𒊓𒀀𒉌𒉡𒋛𒊑𒅁	NEA
𒁹𒈗𒊑𒁁𒅀𒀭𒌓𒅀𒀭𒅀	MPB
𒅇𒀀𒈾𒀀𒁲𒂊𒃻𒈗𒁁𒇷𒉌𒉌𒌁𒌒	NEB
𒁹𒀸𒆠	LTB
𒈨𒂊𒋛𒋛𒂊𒊒	STB
𒄿𒈾𒋡𒋾𒁹𒉺𒉿𒊏	MPB
𒀭𒇡𒉺𒉌𒌈𒀭𒀝	NEB
𒁹𒈗𒊑𒁁𒅀𒀭𒅀𒀭𒌷𒅀𒄿𒍝𒁀𒌅𒈪	MPB
𒄥𒁀𒊑𒂵𒑏𒑏𒊺𒄥𒀭𒌓𒈾𒍢𒅕	OLB
𒀊𒄈𒋢	SUX
𒀭𒊩𒌆𒌉𒁺𒊕𒀭𒁁𒀖𒉌𒉌	SUX
𒊹𒄑𒆹𒊹𒄑𒌉𒂠	SUX
𒌨𒊒𒁺𒈗𒂗𒅀𒅇𒆏𒁉𒆳𒈨𒌍𒅟	MPB
𒊹𒄘𒌦𒋠𒈪𒆳	NEA
𒀸𒅆𒌉𒈗𒀸𒆳𒀸𒋩	NEA
𒇽𒄥𒁍𒌅𒅇𒇽𒀀𒆥𒈨𒌍𒋙	NEB
𒌓𒀜𒋼𒋾	STB
𒀀𒍝𒀊𒋫𒌋𒌆𒇻𒂊𒋫𒉺𒀾𒌨𒆠𒋼	NEA
𒌗𒍩𒌓𒄰	NEA
𒅇𒅆𒅖𒋙𒀸𒆠𒊒𒁀𒀀𒈬𒈨𒌍𒀉𒋰𒋗𒌑𒊹	LTB
𒊹𒀸𒌗𒀳𒀯𒇻𒅂𒆳𒄩	STB
𒀀𒌋𒌉𒃻𒇽𒈾𒁷𒈾	LTB
𒄿𒅎𒈠𒅈𒋗𒅕𒋫𒁉𒁕𒀭𒉌𒄑𒈠𒅇𒄿𒊺𒀪𒂊𒅆𒈠	MPB
𒁍𒌑𒌓𒀀𒄩𒀀𒈩𒀀𒈾𒈬𒌨𒊒𒄣𒃻𒄑𒊒𒁀𒈨𒌍𒈬𒈨𒌍	LTB
𒊩𒌉𒀭𒌨𒈨𒌈𒌉𒊩𒉌	OLB
𒉡𒀀𒉡𒈠	MPB
𒀴𒀭𒀀𒂷	OLB
𒄿𒆳𒁕𒁺𒉌	NEB
𒌷𒅟𒉺𒅁𒉿	NEB
𒁹𒁲𒁁𒊑𒋢𒈗	LTB
𒊹𒌑𒊕𒆠	LTB
𒃻𒂍𒍣𒅖𒌈𒃻𒆍𒉌𒊑𒁉𒋗𒆸𒆸𒍑𒈨𒌍𒌋𒊕𒆠𒈨𒌍𒈪𒋚𒌈	LTB
𒀀𒈾𒆪𒀸𒌓𒁁𒋾	NEB
𒅇𒉿𒁀𒌑	MPB
𒆠𒄿𒈠𒁖𒋫𒀸𒌷𒊑𒁁	NEB
𒀝𒋫𒊐	NEB
𒇽𒃲𒈨𒌍𒀉𒊑𒆪	NEA
𒇻𒊏𒀀𒈨𒀸𒂍𒄰𒈠𒋢𒉌	NEA
𒌅𒌌𒆷	STB
𒌉𒂗𒆪𒇷	SUX
𒆠𒀭𒈾𒉘𒂷𒁕	SUX
𒃻𒋗𒈛𒄩𒋗𒋾𒄿𒈾𒄘𒍣𒅆𒈾𒆬𒌓	MPB
𒀀𒀭𒋛𒀀	STB
𒈠𒋼𒁺𒌋𒀭𒂗	STB
𒋗𒁹𒀭𒂗𒉌𒍪𒌉𒌉	MPB
𒀭𒉄𒊮𒂵𒆠𒂖𒆷𒋧𒋧𒆠	SUX
𒅇𒆠𒄿𒅀𒄠𒁹𒁺𒌋𒁺	MPB
𒌑𒊺𒍝𒀊	STB
𒊹𒊹𒀸𒆳𒋙𒀸𒊹𒋙𒉌𒁺𒈾𒁲	STB
𒊹𒋫𒁄𒀲𒆳𒊏𒈨𒌍	MPB
𒀭𒀠𒇻𒆷	SUX
𒄯𒊕𒊭𒉿𒍝	MPB
𒅆𒊹𒅆𒇲𒀸𒋩	NEA
𒀀𒀀𒄑𒁁𒀭𒂍𒀀𒉣𒈨𒀭𒈨𒌍𒈬𒁲𒂊𒊩𒈠𒋳𒋗𒀀𒇉𒈨𒌍𒋙	STB
𒂗𒅀𒀀𒈾𒅀𒅆	MPB
𒆳𒌵𒀀𒀀	NEA
𒆠𒊒𒁀𒀀𒈬𒈨𒌍𒌑𒈥𒊩𒈠𒀪𒀀𒁲𒊹𒀀𒈾𒊹𒀀𒈾	LTB
𒊹𒊕𒊩𒆳𒀴	OLB
𒁹𒀭𒊏𒁉	OLB
𒁹𒀴𒀹𒁯	OLB
𒃻𒊹𒀸𒄗𒋩𒋀𒋙	NEB
𒀸𒊮𒁉𒀀𒇉𒋫	NEA
𒅟𒅀𒅆	MPB
𒅆𒊹𒌋𒉽𒃲𒆠𒈲	NEA
𒈪𒋫𒌓𒅇𒌉𒈨𒌍𒅀𒀴𒈨𒌍𒈗𒁀𒀠𒌅𒅇𒋾𒅖𒁍𒊒𒈾𒀀𒈾𒈗	MPB
𒊹𒊹𒌓𒊹𒆚𒅆𒅕	STB
𒄿𒈾𒆠𒆗𒂍𒃲𒅀𒌑𒆥	STB
𒆗𒂵𒀀𒈾𒈗𒊑𒂗𒅀	MPB
𒂗𒅀𒀀𒉡𒌝𒈠𒁹𒄩𒋾𒅁	MPB
𒁀𒌅𒈠𒀸𒊏	NEB
𒂗𒆤𒆠𒋫	SUX
𒈗𒂗𒅀𒆠𒄿𒈠𒇽𒈨𒌍𒀀𒁍𒋾𒉡	MPB
𒀀𒌑𒈥𒊩𒈠𒀀𒈾	LTB
𒀀𒈾𒊮𒁉𒅆𒈾𒀀𒊭𒁀𒆷𒀀𒅆𒅁𒅇𒄿𒈾𒀭𒈾	MPB
𒁕𒀀𒆠𒋗𒉡	MPB
𒌅𒄩𒀜𒋰	STB
𒌑𒍝𒆠𒀀𒈾𒊹𒋻𒁲𒀉𒀸𒋩	NEA
𒇻𒊺𒁉	NEA
𒀀𒉡𒌝𒈠𒅖𒌅𒆳𒄭𒀀𒀀𒂖𒅆𒀀𒌉	MPB
𒇺𒁓𒊏𒀭𒈾𒅆𒈠𒀀𒈾	NEB
𒅇𒀀𒉌𒉡𒂍𒉌𒁕𒁍𒁍𒉌	NEA
𒊹𒇽𒍏𒉄𒂊𒉆𒁁𒇷	OLB
𒀴𒊑𒅎𒀭	OLB
𒆬𒌓𒄿𒁺𒉡	NEA
𒊭𒊹𒀭𒉺𒈬𒉽	NEA
𒉈𒂊𒈬	NEB
𒈾𒅇𒀭𒉡𒌑	MPB
𒉆𒄩𒅈𒋾𒁕𒁕𒀀	OLB
𒍑𒊺𒊏𒄠𒇽𒌉𒆥𒅀	MPB
𒈾𒋗𒌑𒉌𒄿𒁕𒁍𒁍𒌝𒈠𒉌𒅋𒋃𒈠	NEB
𒀀𒈾𒌋𒁇𒀭𒌓𒉺𒂆𒍑𒈨𒌍	OLB
𒅇𒀜𒁕𒈪𒅎𒈠𒁕𒊏𒄠𒆗𒄑	MPB
𒅇𒀀𒈠𒋫𒆷𒉡𒋻𒊑𒄑	MPB
𒆲𒍝𒂊𒁕𒋾𒀀𒀭𒌋𒀀𒆗	STB
𒌑𒋚𒄩𒊍𒌝𒈠𒁳𒁉𒐊	NEB
𒋾𒁉𒂊𒌷𒆧𒋙𒋾	STB
𒀀𒈾𒌉𒂍𒃲	NEA
𒁹𒀀𒀕𒆠𒌗𒇯𒌓𒊹	LTB
𒀀𒈾𒈗𒊑𒂗𒅀𒀭𒅀𒀭𒌓𒅀	MPB
𒊭𒅟𒀭𒀀𒈾𒊮𒁉𒌷𒆠𒅇	MPB
𒋠𒉺𒈬	SUX
𒂗𒇷𒀀𒁁𒈗	NEA
𒌗𒀊𒌓𒁺𒂠	SUX
𒅀𒉡𒂟𒈨𒌍𒁉𒋫𒋾𒅇𒅟𒇷	MPB
𒌷𒄬𒍮𒈨𒌍𒊭𒈗𒁁𒉌𒅀	NEA
𒊕𒆠𒀭𒋫𒅎𒈥𒌅𒌁𒄫	LTB
𒃼𒁁𒋼𒋙𒂊𒄈𒌓𒄿𒉺𒋾	NEA
𒁹𒁺𒀀𒇽𒋃𒀀𒃻𒀀𒀕𒆠𒌗𒀳𒌓𒊹	LTB
𒅇𒇻𒌑𒋾𒄿𒋾𒄿𒉡𒈠𒊭𒅆𒈗𒆠𒈠𒀭𒌓𒀸	MPB
𒄠𒈥𒆸𒌅𒌑𒉌	NEA
𒅋𒋳𒉡𒋙𒈠𒀀	NEB
𒋧𒈠𒀀𒈾𒆪𒀀𒈥	NEA
𒈠𒈾𒀀𒄷𒊓𒊹𒈠𒈾𒉌𒌓𒈾𒆪	STB
𒀭𒌨𒊕𒅓𒁉𒌨𒊕𒀭𒅓𒁉	SUX
𒅋𒆗𒉻	STB
𒀀𒁲𒀀𒀭𒀀𒈾𒊹𒀀𒈾𒌓𒈬𒍝𒀀𒌓𒄿𒉆𒁷	LTB
𒌅𒀜𒋻	STB
𒀀𒈾𒄿𒌍𒈾𒅋𒇷𒆪𒉌	NEB
𒀀𒃻𒀀𒈨𒌍𒃻𒀀𒃻𒇽𒋛𒌓𒃻𒂵𒊹𒊕𒆠	LTB
𒁹𒌨𒀭𒊩𒌆𒅁𒌉	SUX
𒀭𒉌𒄿𒁉𒋤𒀝	NEB
𒌓𒊹𒄰𒄷𒌓𒊮𒁉	STB
𒄴𒇷𒄣𒀀𒈾𒆪𒅇	NEB
𒊓𒈪𒌝𒈠	SUX
𒀀𒈾𒆪𒀀𒅟𒈾𒅁𒊺𒂊𒆪𒈠𒀭𒉡𒄿𒇻𒊺𒈾𒊭𒄿𒈾𒈠𒀀𒋾	STB
𒃷𒆹𒀏𒆠𒅟	SUX
𒅇𒌷𒁺𒆷	MPB
𒀀𒈾𒌓𒈬𒍝𒀀𒌓𒄿𒍪𒍪𒀪	LTB
𒂊𒈠𒁕𒅗	SUX
𒄿𒈾𒉺𒉌𒂟𒈨𒌍𒁉𒋫𒋾	MPB
𒍝𒀀𒌓𒌋𒋗𒌓𒅟𒋛𒀀𒋢𒋾𒂠𒃼𒌓𒀭𒀀𒉏𒀭𒂗𒆤𒇲	STB
𒇽𒈨𒌍𒅀𒀀𒊏𒁕	MPB
𒌗𒀊𒌓𒁺𒌓𒊹	OLB
𒂗𒉣𒅔𒉌𒈾𒇡	NEA
𒋗𒉡𒂊	OLB
𒍦𒊒𒊌𒉡𒌋	STB
𒊭𒈗𒅅𒁍𒌑𒉌	NEA
𒄿𒈾𒋢𒀀𒉿𒂟𒌅𒀸𒌗𒉈𒋻𒋢	STB
𒄿𒊑𒁍𒈾𒇽𒊓𒄤𒈨𒌍	MPB
𒉌𒅁𒉺𒀾𒋗𒌅𒈠	NEA
𒌨𒁍𒌑𒌌𒌅𒆳𒉏𒈠𒆠	NEB
𒀀𒉌𒉌𒀀𒈾𒌋𒅗𒄭𒉿𒄿𒋙𒉡𒀀𒈾𒈗	NEB
𒊭𒄀𒅖𒀭𒉺𒂍	OLB
𒆠𒈠𒀭𒋗𒀀𒁍	OLB
𒌓𒊹𒆚𒍣𒉡𒈠𒀪𒁕𒀉𒋫𒋃	NEA
𒃻𒁀𒈗𒀀𒈾𒅁𒉌𒀭𒅎	OLB
𒁍𒌑𒌓𒀀𒄩𒀀𒈩𒀀𒈾𒈬𒌨𒊒𒄣	LTB
𒊍𒈠𒄿𒈾𒂍𒃲	NEB
𒌓𒊹𒌓𒊹𒉽𒅆𒅔𒍣𒊒𒌑𒃻𒌓𒈬𒀸𒊹𒌓𒈬𒀸𒌓𒈬𒈨𒌍	LTB
𒀴𒀭𒌓	SUX
𒊭𒅖𒌅𒂍𒅆𒁾	OLB
𒊭𒀀𒀊𒁀𒊓𒀭𒁲𒋡𒇷𒌈	STB
𒁹𒀭𒂍𒃲𒇷	OLB
𒅆𒄿𒈗𒁁𒉌𒀀𒈾𒀀𒁉𒀉𒀭𒉌𒋼𒈗𒁁𒉌	NEA
𒀸𒋡𒀊𒋛𒆳𒋙𒅅𒋫𒆷	NEA
𒅆𒊹𒀭𒉺𒌋𒀀	NEA
𒊭𒀀𒈾𒅁𒉺𒇷𒋗𒀜𒆤	OLB
𒃻𒅟𒌝𒈠𒉌𒈫𒂊𒈠𒀀𒀭𒉌𒁉𒊒𒀭𒈩𒃻𒁹𒊏𒈠𒉌𒋙𒆕𒌋	STB
𒊭𒊬𒀸𒆠𒈠𒀭𒁺𒃮	OLB
𒌋𒀀𒃻𒀀𒃻𒇽𒉌𒋩	LTB
𒌓𒈠𒅇𒈬𒊭𒊭𒀀𒅆𒁀𒈾𒀀𒂊𒋼𒁍𒍑	MPB
𒃻𒆷𒀀𒊑𒌈	NEB
𒁹𒀀𒉈𒀭𒈥𒌅	OLB
𒉺𒆠𒀭𒁇𒆷𒈬𒋡𒉌	NEA
𒁹𒄿𒋛𒁺𒊒	LTB
𒂗𒈾𒌉𒊹𒁕𒆪𒊒	NEB
𒊹𒀯𒀸𒁁𒀸𒌗𒉈𒋫𒌓𒊹𒆚𒂗𒌓𒊹𒆚	STB
𒊹𒇽𒈾𒁷𒈾	LTB
𒈬𒍝𒇷𒀭𒈗𒁁𒇷𒅀𒄿𒅆𒈪	MPB
𒂊𒃻𒀀𒌈𒂟𒈨𒌍𒊑𒄩𒀀𒌈𒄿𒍠𒅟𒀀	STB
𒈗𒊕𒆗𒌓	STB
𒇽𒉺𒈥𒌅𒈨𒌍𒆠𒋩𒊏𒆠	OLB
𒅇𒅟𒁀𒌅𒅇𒍪𒊒𒈠	MPB
𒀭𒂗𒀭𒀝𒅇𒀭𒌓𒀀𒈾𒈗𒁁𒉌𒅀𒌨𒊒𒁍𒋗	NEB
𒊭𒈪𒉌𒀭𒌓𒂍𒀀𒋢𒌅𒌝	OLB
𒉌𒌓𒈾𒃲	SUX
𒀭𒄩𒄠𒈬𒋗𒀭	OLB
𒀭𒆷𒆠𒁍𒀭𒌋𒄥𒃻𒁲𒄿𒀪	STB
𒌑𒆗𒀠𒆷𒅋𒆷𒅟	NEA
𒌷𒀸𒀸𒄭𒀀𒊭𒉡𒋻𒀉𒇽𒃲	MPB
𒀯𒀀𒇷𒃻𒅔	STB
𒄭𒁉𒌈𒄷𒊏𒍮	STB
𒆳𒈪𒄑𒊑𒊭𒀀𒊭𒀊𒊏𒋾	MPB
𒀀𒈾𒉺𒀭	NEB
𒊹𒀉𒋰𒋗𒌑𒊩𒉌𒄭𒌈𒈾𒁷𒀜𒆠𒊒𒁀𒀀𒈬𒈨𒌍𒌉𒊩𒃻𒌋𒊹	LTB
𒊭𒂗𒅀	NEA
𒃻𒊹𒌌𒈬𒈾𒅆𒇽𒋝𒁕𒈨𒌍𒋙	NEB
𒄿𒁷𒀭𒁕𒃶	OLB
𒀴𒅟𒊹𒈗	NEA
𒌷𒆠𒉌𒅎𒈪𒍏	SUX
𒀸𒁓𒆠𒀭𒈦𒀀𒈨𒌷𒆗𒄭𒃻𒀭	NEA
𒄿𒋡𒁍𒌑𒌝𒈠𒊹𒇽𒊕𒈨𒌍𒅀	NEB
𒌨𒀭𒅗𒁲	SUX
𒇽𒋢𒂔𒆠	OLB
𒅆𒌈𒃻𒊺𒆰𒊹𒌑𒍑𒆠𒌑𒅎𒍇𒇻𒄘𒀀𒇉𒄭𒅋𒌈𒌋𒊺𒆰	LTB
𒌌𒀀𒈾	NEB
𒀭𒊊𒀕𒃲𒋗	SUX
𒁕𒄠𒅗𒀭𒄿𒈾𒍢𒅗	MPB
𒄿𒌅𒊏𒉏𒈠𒀀𒈾𒊩𒍑𒁇𒈨𒌍	OLB
𒊭𒄿𒈾𒊮𒁉𒌷𒆠𒋗𒅇𒋼𒅁𒁍𒍑𒄭𒂊𒁕	MPB
𒈗𒀝𒂗𒄿𒈾𒉺𒉌𒆍𒃲𒀉𒋫𒄭𒄑𒄖𒍝𒋗𒈗𒀝𒂗𒆇𒋗𒂊𒅁𒁍𒊭	STB
𒇸𒇷𒅟𒀸𒌷𒁕𒊏𒀀𒋾	NEA
𒄠𒈨𒉌𒆷𒀀𒁕𒀀𒆪𒌌𒋼𒀀𒍣𒄿𒋗𒀀𒈾𒉺𒉌𒈗𒂗𒅟	MPB
𒈬𒈾𒄀𒅔	SUX
𒌋𒆠𒄿𒊹𒈬𒈨𒌍𒀀𒈾𒈾𒁕𒀭𒃻𒄑𒊒𒁀𒈬𒈨𒌍	LTB
𒀸𒊮𒊹𒂗𒌷𒊺𒈨𒌍𒅀𒇻𒈨	NEA
𒌝𒈠𒌦𒄣𒀀𒊬	NEB
𒁹𒌷𒅀	LTB
𒊹𒌑𒍑𒀭𒋫𒅎𒋛𒁲𒁕𒂍𒊹	LTB
𒇽𒈾𒁷𒂍𒈬𒈨𒌍𒌋𒀀𒃻𒈬𒈥𒊩𒀭𒈾𒂍𒈬𒈨𒌍	LTB
𒋫𒄷𒈬𒂊𒋫𒁀𒊒𒉌	NEA
𒊹𒂆𒆬𒌓𒋡𒇻𒌑𒀀𒈾𒉚𒌀𒈨𒌍𒀀𒈾	LTB
𒈗𒆳𒆳𒁁𒉌𒅀	NEB
𒅖𒌅𒊹𒌗𒌑𒌌𒉿𒄯𒈪𒉺𒉌𒈗	MPB
𒄑𒉺𒄿𒊬𒌅𒊑𒀪𒌑𒌓𒋼𒉌𒊺𒂊𒋾	NEB
𒀀𒀀𒆗𒆷	SUX
𒌓𒈬𒍝𒀀𒌓𒀸𒀭𒁷𒁍𒌓𒀀𒄩𒈩𒀀𒈾𒈬𒊒𒄣𒃻𒂍𒈨𒌍𒈬𒈨𒌍	LTB
𒉡𒋠𒉡𒈠𒋢	SUX
𒊹𒀭𒆬𒆍𒀳𒌍	NEA
𒊹𒀯𒊕𒈨𒃻𒁹𒅆𒀯𒉌𒁁𒀀𒉡𒁺𒄑	STB
𒀭𒄿𒀉𒀀𒇉𒋗	SUX
𒈾𒉺𒁺𒅆𒅔𒉡𒊭𒊹𒈾𒉺𒁺𒄑𒆗	MPB
𒊻𒍝𒀪𒄿𒁍𒌑𒋗𒌑	LTB
𒈗𒂗𒅀	MPB
𒁕𒀀𒁉𒀀𒁺𒌑	NEB
𒃻𒌋𒅗𒌷𒌑𒌅𒃻𒀕𒆠	NEB
𒇽𒆠𒋩𒊏𒆠𒈨𒌍	OLB
𒀀𒉡𒌉𒃻𒌉𒃻𒀀	LTB
𒁹𒌝𒈪𒀭𒊩𒌆𒃲	OLB
𒀀𒁹𒂠𒍪𒌑𒌉𒃻𒀀𒌉𒃻𒀀	LTB
𒀭𒉡𒌨𒀭𒈨𒌍𒍂𒋗𒀭𒅎	SUX
𒊹𒂗𒌓𒈬𒇽𒃲𒈨𒌍	NEA
𒇽𒆕𒌀𒌋𒌆𒇻𒅎𒄭𒀀𒃻𒂍𒀭𒈨𒌍𒃻𒀕𒆠𒉽𒊹𒈨𒌍𒉺𒊹𒃻𒂍𒈬𒈨𒌍𒂍𒈬𒈨𒌍	LTB
𒉣𒃮𒊑𒉡𒌇	STB
𒌑𒋗𒊻𒍪	NEB
𒄯𒊕𒀀𒇉𒇽𒊒𒁕𒋫	SUX
𒀀𒈾𒈗𒍑𒁷𒌋𒆠𒄿𒇽𒂊𒈬𒄣𒀉𒋾𒄿𒉌	NEB
𒁹𒁁𒂖𒋢𒁉𒂊𒇷𒆠	OLB
𒌑𒊺𒁉𒆷𒀾𒋙	NEA
𒋫𒆳𒌅𒌑	NEB
𒀸𒄷𒌓𒊮𒁉𒋙𒂍𒋗𒈫𒋢𒃻𒀸𒂍𒀊𒃲𒀸𒂍𒇽𒌝𒈠𒉡𒀸𒆍𒉌𒊑𒁉	LTB
𒄭𒊑𒁍	MPB
𒀀𒈾𒉿𒄿𒁾𒃲𒇷𒅆𒂠𒊏	STB
𒀸𒅘𒁉𒇺𒄫𒀭𒌓𒁕𒀀𒀀𒉡𒃲𒌑𒃻𒀭𒂊𒌋𒆠𒁴𒈲𒋼𒋓	STB
𒄿𒋛𒀀𒌓𒅆𒇲	STB
𒇽𒂊𒈬𒌓𒁀𒈝𒆠	OLB
𒀀𒄩𒄠𒅈𒅆	SUX
𒊹𒈾𒁷𒉌𒅁𒁍𒍑𒈾𒀀𒋙	NEB
𒁹𒀭𒂗𒍪𒁁𒇷𒉌𒉌	OLB
𒄿𒉡𒈠𒌷𒍮𒈬𒊏𒉿𒀭𒋡	MPB
𒀭𒊓𒊺𒁔𒈫	SUX
𒅅𒆸𒉌𒌓𒄯𒌋𒇅𒀸𒂍𒈨𒌍𒆪𒉡𒀀𒀀𒅁𒅆	STB
𒌉𒊩𒈨𒌍𒆪𒉡𒆠𒄿𒍜𒃻𒄯𒁀𒉈𒇷𒌨𒈬𒊒	STB
𒁲𒉡𒀭𒉡𒌑𒁲𒂗𒆠𒋾𒅀	MPB
𒅖𒌅𒉺𒉌𒈗𒂗𒅀	MPB
𒀖𒁲𒉡𒊹𒋙𒊹𒋙𒇽𒀀𒆥𒈨𒌍	NEB
𒌅𒌨𒊒	OLB
𒊭𒁹𒀀𒉿𒅋𒀭𒂗𒍪	OLB
𒊹𒂄𒇻𒈠𒀀𒋗𒈝	NEB
𒃻𒉌𒌓𒇷𒀉𒊑𒄑𒀀𒈾𒁁𒂗𒅀	MPB
𒋫𒊮𒄿𒊑𒆗𒆷𒊻𒋛𒆷𒀭𒉌	NEA
𒆳𒆠𒆪𒉌𒄴𒌅𒍑𒊭𒀊	STB
𒅋𒄖𒉌𒋗𒌝𒈠𒀉𒋫𒀊𒅆𒅖	STB
𒂍𒈩𒇴	SUX
𒀀𒈾𒀖𒄞𒄭𒀀𒇇𒇻𒄭𒀀𒉡𒋼	STB
𒊹𒊹𒉡𒅆𒇲𒈠𒊻𒅟𒊒𒅆𒅕𒉡𒉽𒈨𒀸𒆳𒅅𒈨𒌍	STB
𒅁𒉿𒆠𒁺𒇽𒊓𒌒𒋼𒉡𒁲𒈾𒀀𒅁𒋫𒆜	NEB
𒃻𒋗𒀭𒈾𒁉𒌝𒈠𒌨	OLB
𒌉𒊹𒊑𒋫𒀀	NEA
𒁹𒊓𒈬𒌝	OLB
𒀭𒀏𒆤	SUX
𒌉𒊹𒄩𒍝𒀀𒀭	NEB
𒆷𒋫𒉺𒈛𒈠𒈾𒋻𒋾	NEB
𒀭𒉡𒋾𒋗𒉡𒌑𒁲𒂊	NEA
𒁉𒉌𒄷𒄭	NEA
𒀀𒈾𒆪𒀀𒈾𒆪𒈠	NEA
𒊹𒄑𒄐	SUX
𒅎𒊑𒄩𒁵𒀀𒌑𒋗𒌅	STB
𒉺𒂍𒄷𒄭𒀀	OLB
𒉿𒊭𒆠𒊕𒅀𒅇𒂗𒉆𒊒	MPB
𒌝𒈠𒈾𒌓𒃻𒈪𒌅𒈠𒉺𒀾𒄷	NEB
𒈨𒌍𒌋𒌆𒇻	NEA
𒅋𒇷𒅟𒆠𒄿	NEB
𒀭𒈾𒅟𒆷	NEA
𒀭𒋗𒁀𒉌	OLB
𒇽𒈾𒍝𒀸𒆠𒌑𒋼𒊏𒀸𒋗𒉡𒋾	OLB
𒀭𒌓𒀸𒄑𒀳𒃻𒀭𒁇𒌷𒆪𒉡𒈾𒄀𒆪𒉡	STB
𒌓𒈬𒉺𒋡𒊑𒀀𒈾𒌋𒅗𒄭𒄑𒊒𒁀𒇽𒆭𒂍𒉿𒊕𒌈𒌑𒌓	LTB
𒅇𒉿𒁕𒂵𒀠𒊹𒅆𒈨𒌍𒅟	MPB
𒌋𒅗𒌷𒆠𒄭𒀀𒅀𒊭𒀭𒆠	MPB
𒊭𒅖𒌅𒆍𒀭𒊏𒆠	OLB
𒀀𒈾𒆪𒌋𒋀𒈨𒌍𒂊𒀀𒊹𒀭𒊹𒋀𒈨𒌍𒋢	NEB
𒀀𒈾𒂍𒍜	OLB
𒀭𒅖𒄩𒊏	SUX
𒀀𒊮𒃷𒋼𒀀𒋼𒀀	SUX
𒇽𒈾𒁷𒄑𒊒𒁀𒈬𒈨𒌍𒌋𒀀𒃻𒀀𒈾	LTB
𒁹𒀀𒄭𒈠	OLB
𒍪𒌑𒋗𒇻𒌑𒍪𒌒𒉺	STB
𒁲𒃻𒄀𒈾𒀭𒌓𒋫	SUX
𒄑𒀀𒋳	MPB
𒈥𒍮𒁴𒍣𒂵	OLB
𒂊𒆳𒌉𒊩𒃻𒌉𒃻𒁮𒌉𒃻𒌌𒋫𒀜𒁷𒌌𒋫𒉆𒁷	LTB
𒊩𒃽𒋢𒉡𒇽𒄈𒇲𒌑𒌓𒅆𒅖𒋙𒃻𒊹𒌓𒈬𒃻𒊩𒋙𒀸𒊹𒃻𒊹𒌓𒈬𒄑𒊒𒁀𒋙	LTB
𒌷𒄿𒁺𒈾𒆠𒀀𒈾𒌋𒅗𒄭𒅀	MPB
𒀭𒂗𒀯𒋗	SUX
𒆠𒄿𒈠𒅋𒋫	MPB
𒀀𒈾𒆪𒅁𒊒𒅖𒌅	MPB
𒇽𒁷𒌁𒆠𒈨𒌍	NEB
𒊹𒊹𒋧𒀀𒇽𒀀𒁀	NEA
𒊹𒌉𒃻𒊹𒀀𒁹𒋀𒀪𒌑𒌅	LTB
𒌋𒌨𒄩𒀜𒋗𒌒𒋗𒂵𒀜𒀀𒆷𒀝𒋫𒈥𒍝𒀜𒆜𒀭𒌷𒁓𒊭𒄩𒀭𒁕	STB
𒀸𒆍𒂍𒃲𒃻𒈗𒀉𒋫𒅆𒍪	NEB
𒀀𒄀𒍠	SUX
𒃻𒊹𒀀𒈾𒆬𒌓𒅎𒄯𒍑𒀭𒌑𒅎𒋛𒁲𒁕	LTB
𒇻𒁲𒈬𒀀𒈾𒌉	NEA
𒁹𒌉𒍑𒅀	STB
𒀸𒋗𒈫𒌉𒃻𒀀	LTB
𒈗𒀀𒊬𒁺𒆪𒃻𒌓𒁺𒋢	STB
𒀸𒊮𒇽𒆗𒇷𒄿	NEA
𒁹𒆠𒅁𒇻𒌑𒉡	LTB
𒀀𒈾𒆪𒌌𒋼𒆗𒌌𒌅	NEB
𒀀𒀀𒅎𒄯𒀸𒋼𒀀𒅆𒌨𒆪𒋚𒈨𒌍𒇻𒅘𒁇𒆪𒉡	STB
𒍣𒈨𒌍𒃻𒈗𒁁𒉌𒅀	NEB
𒀀𒈾𒌋𒌋𒈠𒈨𒁲	NEB
𒅇𒊹𒂗𒇽𒊕𒈗𒇺𒁍𒉘𒈠	NEB
𒅇𒋗𒈝𒇻𒍑𒈪	NEB
𒊩𒆳𒄈𒉣	SUX
𒌅𒌓𒈥	STB
𒉺𒉌𒋗𒀀𒈾𒌑𒁍𒌓𒈗𒁁𒇷𒅀	MPB
𒄘𒊓𒈬	SUX
𒆷𒉿𒅆𒈪𒅇𒈪𒈾𒅁𒁍𒋗𒈾	MPB
𒈬𒊌𒄿𒆷𒅟𒄿𒌓𒍢𒀀𒄿𒋢𒄯	NEA
𒉺𒋼𒋛𒆍𒀭𒆠𒈠	SUX
𒁲𒀪𒌋𒁲𒈜𒌓𒉌𒊓𒌓𒆷𒄭𒂵𒍜	STB
𒌝𒈠𒊹𒄩𒈠𒉌𒌋𒊹	NEB
𒈬𒀭𒈾𒋫𒂍	NEA
𒋛𒇲𒉺𒈥𒌅𒈨𒌍	OLB
𒀭𒊩𒌆𒅟𒐋𒋗	SUX
𒀀𒁹𒋀𒀪𒌑𒌅𒀸𒄷𒌓𒊮𒁉𒋙𒂍𒌈𒋙𒃻𒃻𒀸𒃲𒁲	LTB
𒅇𒂟𒀉𒋾𒋗𒆠𒈠𒅈𒄭𒅖	MPB
𒂗𒅀𒀀𒈾𒆪𒀴𒅟	MPB
𒂅𒁉𒍜𒃻𒂗𒐊	NEB
𒇽𒁍𒄣𒁕𒀀𒀀	NEB
𒁕𒂍𒄩𒆷𒃻𒁹𒁀𒆷𒂅𒈬𒈨𒌍𒀀𒃻𒊹𒊕𒆠𒀭𒋫𒅎𒈥𒌅𒁕	LTB
𒊭𒈬𒀭𒈾𒀭𒉌𒋼𒊭𒀀𒈾𒇽𒁮𒃼𒈨𒌍	NEA
𒌋𒀭𒊩𒌆𒆠𒃲	MPB
𒅅𒋫𒁍𒉡𒌝𒈠	NEB
𒄊𒉡𒌨	OLB
𒁹𒉌𒉌𒅁𒉺𒀸𒊏𒄠	OLB
𒄭𒋫𒁍𒌋	MPB
𒄑𒈣𒁲𒈠	SUX
𒌋𒈬𒍮𒌑𒃻𒂍𒋗𒈫𒈬𒈨𒌍𒊕𒆠𒆠𒋫𒅎𒆳𒊏𒁕𒂍𒀀𒈥𒌈	LTB
𒈝𒉡𒊭𒆳𒉏𒈠𒆠	STB
𒄊𒈾𒁉𒉌𒉌𒋗𒂷𒁾𒁀	OLB
𒅇𒀭𒅗𒀭𒂗𒍪𒉺𒈥𒌅	OLB
𒅇𒊹𒈨𒊺𒆰𒋙𒈬𒀪𒌦𒋾𒃻𒈗𒋗𒌑	NEB
𒅅𒅟𒇻𒄿𒁄𒂁	NEB
𒄭𒊑𒁍𒁍	MPB
𒊹𒂗𒇽𒃻𒂍𒀲𒆪𒁷	NEA
𒈬𒋻𒊑𒂠𒀀	SUX
𒅆𒁍𒁕𒍝	MPB
𒄿𒁳𒋙𒂄𒈬	NEB
𒀫𒀭𒅎	SUX
𒊹𒊹𒌋𒊹𒋃𒄣𒇻	STB
𒃻𒀸𒌓𒊹𒃻𒀀𒈾𒄑𒍎𒃻𒀭𒈹𒇯𒁺𒌑𒄑𒊒𒁀𒋙𒊹𒀸𒊑𒁍𒌑𒀸𒊻𒌉𒄷	LTB
𒊭𒌅𒊺𒁉𒆷𒀭𒉌𒀝𒋫𒅘𒀸𒌋𒅗𒈗	NEA
𒍣𒆤𒀯𒄈𒋰𒀯𒉺𒉈𒊕	STB
𒂗𒈾𒀀𒁺𒌑𒌝𒈠𒀀𒌓	NEB
𒄿𒋛𒋙𒉡𒀉𒌅𒍢𒌑	NEA
𒌓𒌑𒊓𒄷𒊒	NEA
𒌉𒋗𒈨𒅀𒈾	MPB
𒇻𒌋𒊹𒌉𒈨𒌍𒋙𒌉𒌉𒈨𒌍𒋙	NEA
𒀪𒀀𒃻𒀀𒃻𒍑𒆠𒋫𒌑𒅎𒍇𒇻	LTB
𒀀𒁹𒆠𒁷𒀭𒀫𒌓𒊹𒌑𒍑𒆠𒌑𒅎𒍇𒇻𒁕𒂍	LTB
𒀭𒄑𒆠𒁮𒁉𒊩	SUX
𒆗𒈾𒀜	NEA
𒊭𒊹𒀭𒉺𒁺𒉽	NEA
𒀴𒅟𒊹𒋀𒇷𒅀𒀀𒈾𒁲𒈾𒀭	NEB
𒁄𒄩𒌅	MPB
𒀀𒈾𒁍𒊑𒆪𒉡𒇻𒃻𒆸𒌋𒆪𒉡	STB
𒈗𒁁𒉌𒇻𒆷𒄿𒌑𒈨𒀀𒁺	NEA
𒀸𒆳𒌵𒆠𒀠𒋫𒃶𒀭𒂗𒌋𒀭𒉺	NEB
𒁁𒉌𒅀𒀸𒌋𒅗	NEA
𒌝𒈠𒇻𒌑𒋗𒉡𒈠𒀀𒈨𒀭𒉡𒌈𒈨𒂊𒆏𒉺𒋗𒉡𒈠𒀀𒈨𒆬𒄀𒆷𒅁𒊭𒈠𒀀𒈨	MPB
𒀀𒈾𒆷	STB
𒉿𒄿𒅔𒁀	SUX
𒀭𒈗𒌑𒆥	SUX
𒊩𒌆𒀭𒌷	SUX
𒌀𒈨𒌍𒌉𒃻𒀸𒋗𒈫	LTB
𒅇𒋀𒅀𒄿𒈾𒌓𒊭𒀀𒅆	MPB
𒈠𒀀𒋀𒈨𒌍𒄿𒉌𒀸𒌷𒈾	NEA
𒁉𒀀𒈾𒁹𒈠𒉌𒂊	MPB
𒅇𒀭𒆪𒁁𒅀𒆳𒀀𒄯𒊑	MPB
𒃻𒀀𒃻𒅇𒁕𒂍𒋗𒈫𒃻𒁹𒄩𒁀𒀀𒃻	LTB
𒀀𒉺𒊏𒊍𒅟	NEA
𒄘𒈾𒈬	SUX
𒆬𒄀𒅖𒁀	SUX
𒁹𒀀𒇷𒌈	OLB
𒆠𒄿𒀭𒉌𒄿𒊏	STB
𒆠𒊒𒁀𒀀𒈬𒈨𒌍𒄿𒍢𒅇𒈠𒀀𒁺𒈠𒆷𒁀𒋗𒌑𒃮𒁉	LTB
𒋗𒄄𒄄𒂍𒌓𒊏	SUX
𒀭𒀭𒂗𒍪𒈾𒆤	SUX
𒇷𒄴𒇷𒅅𒈬𒆰𒃻𒈗𒂗𒅀𒀭𒂗𒀭𒉺𒀀𒈾𒍝𒀜𒌓𒈨𒇻𒆥𒉡	NEA
𒄿𒅀𒉡𒇽𒈗𒁁𒇷𒊭𒀭𒌨	MPB
𒀭𒆪𒊏	SUX
𒊭𒀝𒈾𒋼	MPB
𒉿𒉿𒍥𒁕	OLB
𒋫𒈠𒊏𒀝𒋗𒈠𒀀𒈾	STB
𒈗𒂗𒀀𒈗𒃻𒈗𒈨𒌍	NEB
𒆠𒉡𒌫𒀀𒄭𒋗𒋫	SUX
𒁹𒀴𒀭𒂗𒍪	OLB
𒌉𒃻𒀀𒌉𒃻	LTB
𒀀𒁲𒊹𒌑𒈥𒊩𒈠𒀀𒈾𒊩𒉌𒁷𒌈𒀀𒈾	LTB
𒀭𒂄𒄀	OLB
𒀊𒁀𒆚𒈠𒀀𒈾𒌋𒅗𒄭𒆪𒉡	NEB
𒊹𒊹𒀸𒉣𒇬𒊹𒁺𒆳𒆕𒀀𒁉𒆤𒌓	STB
𒊭𒄑𒈬𒉺𒂍	OLB
𒊹𒇽𒋃𒀀𒃻𒀀𒀕𒆠𒌗𒇯𒆚𒌓𒊹𒈬𒊹	LTB
𒋙𒀀𒆠𒈠𒁲𒂊𒊏𒉺𒀾	NEB
𒁹𒀭𒌓𒈾𒄴𒊏𒊑	OLB
𒂗𒉿𒆥𒋾𒊭	NEA
𒊮𒁍𒋗𒄿𒋡𒍣𒋗	MPB
𒀀𒆳𒈗𒀀𒈾𒌋𒅗𒊹𒌒𒊏𒁉𒀝𒋫𒁉	NEB
𒁀𒋾𒄣𒌓𒀸𒌋𒅗	NEA
𒅈𒁲𒅖𒌒𒄭𒅖	STB
𒅍𒈗𒄱	SUX
𒌋𒂟𒈨𒌍𒃻𒅅𒁍𒌑	NEB
𒅎𒊹𒀀𒈾𒈗𒁁𒉌𒋙	NEB
𒃻𒌋𒌋𒃻𒀸𒂍𒀀𒅆𒇽𒀸𒃮𒊑𒋙𒆷𒄿𒋼𒀀𒊏𒁍	STB
𒅇𒋳𒈠𒆠𒀀𒈠𒄿𒁀𒋗	MPB
𒃻𒌋𒊹𒌑𒍑𒆠𒌑𒅎𒆳𒊏𒁕𒈬𒍮𒌑𒃻𒂍𒈬𒈨𒌍𒊒𒄖𒁍𒊭𒀸𒌋𒅗𒄭	LTB
𒁹𒆰𒅀	LTB
𒋗𒆸𒆸𒌋𒌋𒌋𒌋𒌋𒌋𒅂𒅂𒃷𒃷𒃷𒃷𒈦𒃷𒌋𒌋𒌋𒁹𒁹𒁹𒁹𒁹𒊬𒋞𒅇𒆪𒊒𒌝	SUX
𒀀𒉡𒈠𒊹𒇽𒆳𒈪𒄑𒊑𒋗𒉡	MPB
𒄿𒋛𒈨𒈠𒀀𒇽𒂗𒉆𒊭𒌷𒇹𒄩	NEA
𒌉𒀀𒈾𒈪𒉌𒋗𒂊𒈪𒀉	OLB
𒃻𒌋𒌋𒊐𒄫𒉌𒄭𒅖	STB
𒀭𒍂𒊑	SUX
𒅇𒀠𒆷𒀝𒈪𒀀𒈾𒆪𒀀𒈾𒌷𒀀𒇥𒆠	MPB
𒊌𒂵𒌈𒊏𒀪𒀀𒁍	STB
𒀀𒈾𒌉𒃻	LTB
𒉌𒉿𒋙𒋙𒉡𒀜𒊒𒋾	NEB
𒌓𒁲𒈾	NEA
𒀀𒈨𒌍𒀀𒃻𒀀𒃻𒌋𒀀𒃻	LTB
𒀉𒋾𒀭𒌓𒉡𒅆𒅕	STB
𒁺𒀀𒆠𒄿𒀀𒄩𒀀𒀀𒅖	NEA
𒁹𒄿𒁷𒀭𒍂𒇽𒄭	OLB
𒆬𒌓𒀀𒀭𒊹𒂆𒉚𒆠𒊒𒁀𒀀𒈬𒈨𒌍𒌀𒈨𒌍	LTB
𒈨𒌍𒋙	NEB
𒁹𒀭𒄿𒋳𒀀𒁉	OLB
𒊹𒀯𒀸𒋛𒊹𒋙𒁺𒀭𒈪𒈗𒈥𒆠	STB
𒁁𒉌𒅀𒀀	NEA
𒍢𒉌𒀭𒂗𒆤	OLB
𒉺𒋧𒈠	SUX
𒍝𒀊𒌅𒈪𒊓𒄤𒈨𒌍𒅇𒄿𒊭𒆷𒇻𒅆	MPB
𒉿𒁲𒈗𒊒𒁉𒇷𒀀𒁀𒀜	MPB
𒅋𒋫𒃶𒌷𒈠𒋥𒈠𒀀𒋫𒃻𒋗𒊹𒈗	NEB
𒌅𒋼𒊒𒈾𒀀𒉿𒌓𒀀𒈾𒅀𒅆	MPB
𒀀𒈾𒆳𒀀	NEA
𒁹𒀭𒅗𒀭𒈾𒈾𒀀	OLB
𒇽𒈨𒌍𒄩𒍝𒉡𒋾	MPB
𒀭𒍣𒇷𒇷𒌈𒊩𒈛𒀭𒈠𒀭𒍝𒀜𒆤	SUX
𒅇𒂗𒄩𒆷𒈨𒌍𒋙𒉡𒀀𒈾𒊹𒈠𒈾	LTB
𒊕𒁺𒋢𒌑𒄯𒊏𒌒𒊕𒁺	STB
𒄿𒉆𒁷𒁍𒌑𒌓𒀀𒄩𒀀𒈩𒀀𒈾𒈬𒊒𒄣𒃻𒂍𒋗𒈫	LTB
𒄿𒈾𒀫𒀸𒈬𒁕𒄵	NEA
𒌌𒌅𒌗𒀊𒃻𒇽𒃲𒇻𒁕𒊑𒀀𒅋𒇷𒅟	NEB
𒁷𒌁𒆠𒄿𒉺𒅁𒌓	NEB
𒊹𒅕𒍢𒌓𒀸𒌗𒋞	STB
𒄣𒆷𒀀𒋫𒅅𒊑𒇻𒀴𒊹𒂗𒁍𒁍𒌅	NEB
𒀸𒅆𒊹𒋫𒀀𒁀	NEA
𒊹𒌓𒈬𒊩𒉌𒁷𒌈𒀭𒈾𒈾𒀀𒈾𒃻𒀜	LTB
𒇻𒌋𒁉𒆷𒈾𒅆	NEA
𒇽𒇻𒊓𒉌𒆥𒇻𒊺𒍢𒀀	NEA
𒀊𒋾𒆥𒁲𒀀𒈾𒆪𒀀𒊓𒄷𒊒	NEA
𒈬𒄰𒊭𒀜𒁕𒀭𒉌𒁕𒅇𒇻𒌌𒇷𒅅	MPB
𒇽𒄢𒇻𒁍𒌅𒃻𒊹𒌷𒁀𒀭𒀫𒌓	NEB
𒄘𒋻𒈬	SUX
𒊩𒁁𒉌	STB
𒊹𒇽𒅟𒈲𒈨𒌍	NEA
𒀀𒅟𒀾𒃻𒁺𒌋𒉌𒈗𒀖𒁲𒈾	NEA
𒈗𒊒𒊹𒋫𒁄𒀲𒆳𒊏𒈨𒌍𒋡𒁺𒄑𒇀	MPB
𒀴𒅟𒊹𒀀𒃼𒀭𒂗𒇻𒄯	NEB
𒉺𒋗𒄿𒊭𒊑𒅎𒀭𒂗𒍪	OLB
𒅖𒉺𒊒𒌋𒉌𒆠𒄿𒀊𒌅𒌋𒀠𒋫𒅆	NEB
𒌓𒈬𒈠𒆷𒊹𒍢𒁍𒌑𒄑𒊒𒁀𒈬𒈨𒌍𒀸𒄑𒁕𒃻𒄑𒊒𒁀𒈨𒌍	LTB
𒊏𒊍𒉺𒂵𒈬𒊏	NEA
𒀭𒈾𒈾𒀀𒀭𒃽𒂔𒀭𒃽𒃻𒂍𒊕	LTB
𒅇𒆠𒄿𒀀𒆳𒀀𒁉𒅋𒋾𒀸𒉺𒀭𒈗	NEB
𒀀𒀀𒁹𒋀𒀪𒌑𒌅	LTB
𒈬𒈨𒌍𒂍𒆪𒊒𒌒𒁍𒈬𒈨𒌍𒄿𒍢𒌋𒈠𒀀𒁺𒈠𒆷𒁀𒋗𒌑	LTB
𒌀𒈨𒌍𒅅𒈨𒌍	STB
𒉡𒇷𒄫𒋾𒇷𒄫𒋾	STB
𒀸𒉌𒌓𒀭𒋩𒉣	STB
𒌷𒊺𒊹𒆜𒁍𒆕𒄣𒊒𒀀𒁲	NEA
𒅅𒋻𒁍𒌋𒉌𒋫𒈣𒈨𒌍𒉌	NEA
𒀸𒋫𒉌𒄭𒁲𒈜𒋾𒈾𒄫𒋾𒆪𒉡𒌨𒋾	STB
𒈠𒁀𒉡𒌋𒆹𒂍𒂗𒁁𒈝𒌫𒊕𒂷𒋗𒁁𒀭𒌓𒁈𒃻𒀸𒌗𒋞	STB
𒂗𒀭𒆠𒁉𒁕	SUX
𒉽𒁀𒉡𒌑𒌓𒀀𒈾𒀀𒃻𒀀𒃻	LTB
𒅟𒊍𒁍𒌓𒀀𒈾	MPB
𒀸𒄑𒂟𒆳𒄩𒀸𒅆𒀭𒌓𒁺𒂦𒉌𒌓𒂇𒊹	STB
𒇽𒌉𒈨𒊑𒅀𒌓𒈠𒊏	NEB
𒁀𒋫𒆟𒆟	SUX
𒀀𒈾𒄊𒈨𒌍𒄠𒆪𒌓	MPB
𒄴𒈨𒀭𒊊𒀕𒃲	SUX
𒂍𒀭𒈗𒄊𒊏𒃻𒆠𒆗𒀕𒆠𒊹𒑛𒌑𒍑𒀭𒌑	LTB
𒁍𒌑𒌓𒀀𒄩𒀀𒈩𒀀𒈾𒈬𒌨𒊒𒄣𒃻𒄑𒊒𒁀𒇽𒆭𒂍𒌑𒌓𒈬𒈨𒌍	LTB
𒇺𒁓𒀭𒉌𒌋𒅀𒀀𒉡𒌑	NEB
𒂍𒃻𒂵𒆤	SUX
𒈗𒁁𒅀𒄿𒁲𒋳𒈠𒆷𒄿𒇷𒌑	MPB
𒁕𒀀𒊮	STB
𒆠𒈥𒆠𒅥	STB
𒄿𒈾𒋡𒋾𒋗	MPB
𒌷𒍮𒈬𒌨𒀀𒁲𒀀𒁍𒇷𒅆	MPB
𒂊𒉺𒋙𒌋𒉌	NEA
𒀭𒍣𒁀𒀭𒇉𒀭𒁲𒋻	SUX
𒈠𒁲𒉌𒄿	NEB
𒀉𒄨𒁉𒐕𒐕𒐕𒐕𒌋𒌋𒌓𒁹	SUX
𒀭𒅆𒆳𒍝𒈫	SUX
𒁹𒀀𒉈𒆪𒁉𒋗𒄿	OLB
𒆰𒀀𒉌𒃶𒌀	SUX
𒊹𒀸𒌗𒃶𒅎𒂂𒅅𒌉	STB
𒊹𒅆𒊺𒁇𒆷𒀀𒂟𒉈𒈠	NEB
𒂊𒈨𒁕𒉌𒄿𒉌	NEA
𒌅𒁀𒇻𒈾𒄭𒅆𒄴𒋫	MPB
𒁹𒅀𒀭𒄩𒈬𒅇𒊏𒁉𒍢	MPB
𒅖𒌅𒀀𒈠𒋼𒈨𒌍𒂗𒅀	MPB
𒅇𒁹𒆠𒆗𒀭𒃽𒀀𒈾𒊩𒆸𒈲𒅖𒌈𒌉𒊩𒁹𒀭𒈾𒈾𒀀𒆚	LTB
𒅇𒄠𒈨𒉌𒊹𒋙𒊹𒋙𒀀𒈾𒈗𒁁𒉌𒄿𒉌	NEB
𒀲𒄯𒁁𒅟𒀀𒉌𒀸𒄊𒊹𒊭𒀭𒈦𒈦𒌑𒊺𒊐	NEA
𒇷𒆰𒂼𒌋𒅗𒌉𒊩𒋾𒃻𒆍𒃻	STB
𒊹𒊹𒆜𒉡𒄿𒈾𒀀𒊬𒀀𒅆𒅁	MPB
𒅁𒉺𒆷𒊍	OLB
𒀸𒆳𒇻𒄬𒌨	STB
𒊹𒊹𒀸𒅆𒇲𒋙𒃻𒉿𒅋	STB
𒊹𒆠𒀸𒈪𒄿𒉡𒍑	STB
𒀴𒅟𒊹𒀀𒅆𒉺𒀀	NEA
𒊭𒅆𒌓𒁍𒌑𒊒	MPB
𒄭𒃻𒌋𒌋𒈠𒃻𒉆𒈠	NEB
𒊌𒁷𒉡𒍑𒌋	NEB
𒌌𒌅𒂗𒆤𒆠𒀀𒈾𒉺𒀭	NEB
𒌑𒊭𒁺	MPB
𒆷𒅎𒈠𒄖𒊒	NEA
𒈠𒀀𒇷𒈬𒌓𒊺𒋰𒆪	NEA
𒌝𒈠𒊑𒅁𒀜𒁲𒀴𒅟	MPB
𒀀𒈾𒅀𒅆𒌨𒊒𒁀	MPB
𒊹𒊹𒊹	STB
𒊭𒆍𒃲𒀭	OLB
𒆠𒄿𒈨𒂊𒄿𒈾𒀸𒊏𒉡	MPB
𒀜𒄿𒉺𒀠𒅆𒈾𒋗𒈠𒂊	STB
𒅆𒊹𒂗𒋗𒌋𒀀	NEA
𒀀𒋙𒌑𒈥𒊩𒈠𒀀𒁲𒊹𒀀𒈾𒌋𒁹𒀭𒈾𒈾𒀀𒈬	LTB
𒊹𒀉𒌑𒊒𒌑𒊭𒀲𒆪𒁷𒈨𒌍	NEA
𒅇𒊭𒀀𒇻𒈪𒁹𒈗𒊒𒂗𒅀	MPB
𒀭𒀭𒁔𒃲𒈫	SUX
𒀀𒉡𒈠𒉡𒆳𒌅𒁹𒍣𒅎𒊑𒁕𒇽	MPB
𒊭𒋀𒅀𒌌𒋼𒉋	MPB
𒉺𒅁𒀀𒈾𒅆𒌓𒋾𒅟	NEB
𒊹𒊹𒉣𒇬𒆸𒈠𒀯𒀠𒈜𒀸𒊮𒋙𒁺𒄑	STB
𒃻𒊹𒀭𒂗𒁷𒀉𒊹𒀭𒀝𒄿	NEB
𒁹𒀀𒈾𒀹𒁯𒀜𒆗	OLB
𒆠𒈫𒀭𒂗𒆤𒀭𒈨𒌍𒀀𒅆𒅕𒄒𒊏𒋼𒀸𒌋𒅗𒄭𒈠𒋡𒁉	STB
𒀀𒀀𒈾𒌓𒈬𒍝𒀀𒌈𒋫𒋫𒁷𒆬𒌓𒀀𒀭	LTB
𒋢𒈦𒄣𒋢𒈠𒀾𒆪	STB
𒌑𒇷𒄿𒋼𒁹𒈗𒊒𒂗𒅀	MPB
𒈬𒌦𒆕	SUX
𒀀𒃻𒌋𒊹𒌋𒋀𒈨𒌍𒋙𒀀𒈨𒌍𒃻	LTB
𒌅𒊬𒀪	STB
𒀀𒈾𒈠𒀀𒋼	NEA
𒀭𒃽𒃻𒂍𒊕𒀭𒊬𒊏𒄭𒄿𒌈𒌋𒀭𒈨𒌍𒂍𒈨𒌍𒋙𒉡𒃮𒁉𒃻𒌗𒊻𒋢𒆗𒈬𒀭𒈾	LTB
𒀭𒁲𒉡𒅟𒈬𒌦𒁲𒋗	SUX
𒅅𒋫𒈾	NEA
𒃻𒋗𒀭𒂗𒍪𒁁𒂖𒉌𒉌	OLB
𒋻𒆷𒌈	STB
𒆠𒊒𒁀𒀪𒃻𒁉𒈩𒋙𒉡𒀸𒌗𒋗𒈬𒊹𒁹𒀭𒋾𒀪𒆪𒋢𒈗𒀸𒄷𒌓𒊮𒁉𒋙𒉡𒆠𒀀𒄩𒀀𒈩𒀀𒈾𒌓𒈬𒍝𒀀𒌓𒄿𒍪𒍪𒀪	LTB
𒀜𒁕𒉡	STB
𒂟𒊭𒄿𒈾𒋫𒂇𒋾	NEB
𒈠𒀀𒋫𒇽𒃲𒈨𒌍𒀀𒈾𒆳𒈠𒋫𒀀𒀀	NEA
𒊹𒊕𒀴𒇽𒈨𒌍	OLB
𒀀𒈾𒂍𒃲𒌒𒇴	OLB
𒈠𒀀𒇽𒂟𒈨𒌍𒀀𒇷𒂊	NEA
𒄭𒂵𒀸𒅆𒀭	STB
𒊹𒊕𒀴𒈬𒌦𒈾𒀊𒌅	OLB
𒀀𒉡𒈠𒀉𒋫𒀠𒂵𒀝𒆪𒆠𒄿𒊭𒁖𒁍𒌑	MPB
𒀀𒈾𒉿𒉿𒋙𒉡𒀉𒋫𒋃	NEB
𒆷𒀀𒀀𒈾	MPB
𒁹𒄥𒊒𒁺𒌝	OLB
𒀸𒃮𒅀𒄿𒊑𒅟	NEA
𒁹𒌝𒈪𒁕𒁀𒀜	OLB
𒈾𒈾𒋳𒄀	SUX
𒀀𒆠𒄿𒃻	NEB
𒅎𒀫𒅎𒀫𒈠𒁺𒄑𒁺𒄑𒈠	STB
𒁲𒈬𒀀𒈾𒆳𒊭𒈗𒂗𒐊	NEA
𒂦𒋀𒀊𒆠𒈠	SUX
𒁲𒋻𒀀𒈾𒋗𒉡𒁄𒂊	SUX
𒊹𒊕𒊩𒆳𒊹𒊩𒌉𒊭𒅖𒌅𒄿𒌅𒊏𒉏	OLB
𒀸𒋗𒊹𒅀𒊭𒄿	NEA
𒊹𒀴𒂍𒃲	OLB
𒋫𒁉𒀉𒈗𒁁𒉌	NEA
𒌀𒈨𒌍𒀀𒈾𒊹𒌉𒃻𒊹𒀀𒁹𒂍𒆳𒍝𒄫𒀀𒈾𒌓𒈬𒍝𒀀𒌈	LTB
𒊹𒀀𒁉𒄩𒊑𒅋𒋃𒀭𒉌	NEA
𒆠𒇽𒀭𒋀𒆠𒁮𒃼	SUX
𒂍𒀭𒅎𒃻𒆠𒆗𒀕𒆠𒊹𒌑𒅎𒋛𒁲𒁕𒂍𒌉𒃻	LTB
𒀭𒊩𒌆𒂍𒄄𒀀𒈫	SUX
𒑏𒑏𒇽𒅕𒍢𒁴	OLB
𒀭𒊩𒌆𒈨𒍪𒈫	SUX
𒃻𒌉𒈨𒌍𒃻𒌉𒃻𒈨𒌍𒉺𒊹𒃻𒂍𒈬𒈨𒌍𒊹𒌑𒅎𒋛𒁲𒁕𒂍𒁹𒀀𒊑𒄑𒌅𒌑𒉡	LTB
𒄿𒉡𒈠𒂵𒀸𒋫𒆪𒀀𒈾𒆪	MPB
𒌅𒄩𒄠𒈦	STB
𒅖𒁍𒊒𒆠𒄿	NEB
𒃻𒌷𒂦𒈗𒊌𒆠	NEB
𒀭𒋀𒆠𒀭𒂗𒍪	SUX
𒁮𒍪𒌉𒊩𒋾𒀜𒋫𒀭𒈾𒀸𒋗	MPB
𒉽𒀸𒆳𒄿𒌨𒆠	STB
𒀀𒈾𒈗𒌨𒊒𒁍	NEB
𒇷𒄯𒅆	NEA
𒉡𒌫𒀀𒄭𒅖	SUX
𒂍𒋗𒈫𒈬𒈨𒌍𒃻𒀸𒂍𒈬𒌁𒌈𒃻𒆍𒃲	LTB
𒊭𒄿𒈾𒌷𒈠𒀭𒋾𒉡𒆠	OLB
𒀀𒈾𒊹𒈨𒌍𒋼𒁹𒂗𒈨𒌍𒋙𒄥𒊏	NEA
𒆳𒌒𒁍𒌓𒅋𒆷𒅟	STB
𒌋𒀀𒈨𒌍𒃻𒀀	LTB
𒀸𒋗𒈬𒃻𒊹𒀀𒂵𒀀𒀀𒃻𒁹𒁀𒆷𒂅𒀀𒈾𒆬𒌓𒀸𒋗𒈫𒀀𒃻	LTB
𒌑𒋰𒁀𒁍𒈠𒁹𒌋𒅗𒆪𒌑𒊑	STB
𒆠𒄿𒅁𒂅𒊒𒍑𒃻𒊏𒋾𒋙𒈠	NEB
𒁹𒇻𒌑𒇷𒈬𒌦𒇷𒁍𒊏	OLB
𒉺𒉌𒌑𒋫	NEA
𒀭𒉣𒃲𒀭	SUX
𒊒𒁴𒈧𒀲𒃻𒀭	STB
𒆠𒄿𒀉𒁷𒌋𒆠𒄿𒀉𒆗𒉡𒌌𒁺𒍪𒌋𒄿𒉆𒁷𒃻𒆷𒁲𒋻	LTB
𒇻𒈠𒊺𒅕	MPB
𒊭𒉿𒄿𒋙𒇺𒈪	NEA
𒋢𒈾𒁕𒆪𒉡𒇻𒋫𒄭𒁉	STB
𒅇𒀭𒊩𒌆𒅁𒀀𒁉𒋀𒀀𒉌	OLB
𒊹𒈠𒈾𒋼𒅕𒋛𒌅𒊹𒈠𒈾𒊭𒁕𒀀	STB
𒀭𒉆𒋻𒍪𒈫	SUX
𒀀𒈾𒈗𒆳𒉏𒈠	NEA
𒈠𒀀𒀲𒆳𒊏𒈨𒌍𒋫𒆳𒄿𒉌	NEA
𒂊𒄷𒊻𒍪𒅆𒈫𒈾𒂇𒌈	STB
𒀭𒌓𒀀𒈾𒆪𒀴𒆠𒋾𒅟	MPB
𒊩𒌷𒊮𒌷𒊬𒋥	NEA
𒌑𒈥𒊩𒈠𒀀𒈾𒌓𒈬𒍝𒀀𒌓𒀀𒈾𒌉𒃻	LTB
𒀭𒊥𒄖𒌓𒈨𒉈𒈫	SUX
𒀀𒈾𒁷𒍣𒈨𒌍𒃻𒈗	NEB
𒇻𒌑𒅖𒋫𒄩𒄭𒅔	MPB
𒀭𒂄𒉺𒌓𒁺𒋗𒁮𒁉	SUX
𒁕𒈨𒌍𒉺𒃻𒉌𒌈𒃻𒂍𒈬𒈨𒌍𒌋𒁕𒂍𒌉𒃻𒊹𒌑𒊕𒆠𒀭𒋫𒅎𒈥𒌅𒁕𒆠𒊒𒁀𒀀𒃻	LTB
𒈪𒉌𒀜𒋫𒈠𒋾𒌍𒋰𒊒𒈾	MPB
𒀭𒈾𒍣	SUX
𒀭𒊩𒌆𒄃	SUX
𒆠𒄿𒊻𒍢𒍮	NEB
𒈠𒆠𒂊𒆥	NEA
𒌉𒀭𒂗𒍪	OLB
𒄿𒊩𒅆𒈠𒀸𒋗𒈫𒊹𒀀𒂵𒀀𒌌𒌑𒊺𒋾𒅅𒌋𒈠𒄠	LTB
𒀀𒃻𒀀𒈾𒌓𒈬𒍝𒀀𒌓𒋗𒌑	LTB
𒌋𒊹𒋀𒋙𒊹𒑛𒌑𒊕𒆠𒀭𒋫𒅎𒈥𒌅𒁕𒂍𒅎𒆳𒊏	LTB
𒊹𒃻𒁹𒀭𒋾𒀪𒆪𒋢𒉽𒁀𒉡𒌑𒌓𒀀𒈾𒉚𒌀𒈨𒌍𒀀𒈾𒌉𒃻	LTB
𒇷𒁲𒆪𒉡𒀀𒀀𒌑𒊺𒍢𒀮𒆳𒆲	STB
𒂊𒋼𒁍𒍑	NEB
𒃻𒊹𒃻𒀭𒉺𒋗𒌑	NEB
𒀭𒊩𒌆𒊭𒌷𒁺𒆷𒋾𒁲𒂗	MPB
𒆜𒁍𒀀𒈾𒊹𒈨𒌍𒋼𒀀𒈾𒂗𒋙𒄥𒊏	NEA
𒈬𒈨𒌍	LTB
𒀭𒂗𒈨𒋼	SUX
𒇽𒈬𒁺𒀀𒃻𒀀	LTB
𒊮𒂟𒊹𒇽𒀀𒋛𒀸	OLB
𒉆𒄩𒅈𒋾𒅁𒉌𒀭𒂗𒍪𒃲𒉌𒍣𒂵	OLB
𒀀𒈾𒆪𒃻𒋫𒈠𒊒𒌑	NEB
𒄿𒉡𒈠𒊭𒀠𒈬	MPB
𒆠𒈠𒁹𒋻𒋻𒀀𒁉𒀀𒁉𒅀	MPB
𒀀𒈾𒇽𒃲𒊕𒂗𒅀	NEB
𒌗𒂙𒊺𒄑𒉌	SUX
𒌅𒌓𒋼𒊏𒅇𒁳𒁉𒆷𒁳𒁉	NEB
𒌗𒄞𒋛𒋢𒂠	SUX
𒌔𒆠𒀀	SUX
𒉌𒁉𒀪𒆠𒁴𒆪𒈬𒌋𒀉𒊏	STB
𒄠𒈥𒀀𒊏𒅆	NEA
𒀭𒀴𒊏𒃲𒁮𒁉𒊩𒀭𒊊𒀕𒃲𒆤	SUX
𒅇𒋫𒀊𒋗𒄴𒆳𒈗	MPB
𒀀𒈾𒄭𒁲𒐊𒄿𒋫𒊏𒆠𒄿𒉿𒄿	NEB
𒁀𒊑𒂵𒑏𒑏𒍥𒍑𒀀𒈾𒆠𒁉𒃻	OLB
𒇻𒆷𒉌𒃼𒊑𒅁	NEA
𒉌𒅅𒁉𒀀𒈾𒈗𒆗𒂵𒈨	MPB
𒈨𒁲𒈠	SUX
𒌓𒊹𒌓𒊹𒌓𒊹𒌓𒊹𒌓𒊹𒉽𒅆𒅔𒍣𒊒𒌑𒃻𒌓𒈬	LTB
𒌨𒀭𒉺𒊕	SUX
𒊮𒊭𒀠𒆷𒀜𒌷𒊭𒋫𒀠𒆷𒆠	OLB
𒆰𒇷𒍪	STB
𒄥𒈠𒋫𒈥𒊩𒀀𒈾𒁕𒀊𒋾𒍝𒆪𒋾	STB
𒀀𒄯𒉌𒄿𒉡	MPB
𒀀𒈾𒌋𒅗𒉈𒂊𒈬𒃻𒈗	NEB
𒅇𒂗𒈾	NEB
𒁹𒂊𒆷𒈪𒌈	OLB
𒃻𒊹𒃻𒋳𒅟𒋢𒌑𒊹𒃻𒉌𒄑𒊹𒊍𒉌𒂊𒌋𒄑𒆲𒃻𒇻𒀴𒀸𒌓𒊹𒆠𒊓𒊩	LTB
𒊹𒊕𒊩𒆳𒀴𒍑𒁇𒈨𒌍	OLB
𒊭𒄿𒁉𒀭𒈥𒌅𒉺𒈥𒌅𒋞𒆠	OLB
𒊩𒁍𒀪𒄿𒌈𒆬𒌓𒀀𒀭𒑚𒈠𒈾𒉚𒊩𒆳𒈬𒈨𒌍𒌀𒈨𒌍	LTB
𒀀𒈾𒌷𒆠𒅇𒀸𒁍𒌨𒀀𒈾𒂍𒃲	MPB
𒀭𒊩𒌆𒌋𒄖𒊷	SUX
𒉺𒋫𒅈𒂟𒈨𒌍𒆠𒆗𒄒𒁁𒇷𒅀	MPB
𒋃𒀭𒈹	SUX
𒊹𒌉𒃻𒊹	LTB
𒅇𒅖𒌅𒀀𒈠𒋼𒈨𒌍𒁹𒁺𒌋𒁺	MPB
𒊭𒄿𒈾𒂍𒀭𒂗𒍪𒅁𒉌𒋗𒉺𒂆𒍑𒈨𒌍𒅋𒇷𒆪𒌑	OLB
𒀀𒈾𒌋𒅗𒄭𒅀𒅖𒃻𒀪	NEB
𒄑𒋫𒌁𒊏𒉡𒃻𒁹𒀭𒋾𒀪𒄿𒆪𒋢𒉽𒁀𒉡𒌑𒌓𒀀𒈾𒉚𒌀𒈨𒌍	LTB
𒀸𒌷𒀊𒁺𒁲𒀸𒌋𒅗𒊹𒀭𒂗	NEA
𒊍𒊓𒉺𒊏	NEA
𒀀𒁲𒌋𒅗𒄭𒊹𒈬𒀭𒈾𒈨𒌍𒁉𒅔𒉆𒈠𒇽𒊑𒋛𒅔𒉡𒌑𒌓𒅟𒇻𒁍𒍑	LTB
𒌦𒂊𒃶𒍪𒍪	SUX
𒀀𒈨𒌍𒀸𒌋𒅗	STB
𒅇𒋾𒈬𒊒𒇽𒈨𒌍𒌷𒁺𒌒𒇷	MPB
𒁕𒈬𒍮𒌑𒃻𒂍𒋗𒈫𒈬𒈨𒌍𒌋𒁕𒂍𒀀𒇻𒌑𒃻𒂍𒋗𒈫𒂊𒇷𒉌𒌈𒈬𒈨𒌍	LTB
𒋧𒈠𒋢𒌑𒈠𒅎𒋫𒄯𒅟	STB
𒆠𒄿𒊭𒈗𒁁𒉌	NEA
𒀭𒂗𒍪𒂵𒅖𒍣𒂵	OLB
𒈗𒌵𒆠𒄑𒆪𒈨𒌍𒋙	STB
𒊹𒆪𒊑𒃲𒍪𒋀𒋙𒀭𒂗𒌋𒀭𒀝	NEB
𒅎𒈥𒌅𒁕𒂍𒌉𒃻𒊹𒑛𒌑𒊕𒆠	LTB
𒊭𒅖𒌅𒈬𒋾𒀀𒁀𒀠𒆠	OLB
𒁹𒄥𒊒𒀸	OLB
𒆠𒈫𒆠𒈫𒆠𒄿𒍪𒌝𒁉𒀸𒋗𒊹𒇽𒉽𒆪𒉡𒇷𒉺𒋗𒆪𒉡	STB
𒀭𒊓𒃲𒈫	SUX
𒆠𒈾𒈾𒆷𒀀𒁄𒄷	MPB
𒄑𒋛𒅀𒌒𒁀𒆷𒀾𒋙	NEA
𒊮𒄘𒌦𒀭𒀫𒌓𒈾𒍢𒅕	OLB
𒁀𒊑𒂵𒑏𒑏𒑏𒊺𒊹	SUX
𒌑𒀀𒆷𒍝𒆪𒌑	NEB
𒌅𒊕𒊏𒌒	STB
𒊭𒊮𒌓𒂵𒉌	NEA
𒊭𒀀𒈾𒂍𒈛	OLB
𒅆𒅁𒌅𒌑𒌌𒄿𒅀𒁺𒅆𒉺𒀜𒀭𒁕𒈬	MPB
𒊹𒇽𒈨𒌍𒆳𒈪𒇻𒄩𒊹𒇽𒈨𒌍𒆳𒈪𒄑𒊑	MPB
𒄿𒈾𒂊𒇷𒅟𒀀𒈾𒁀𒀊𒀭𒀀𒉌𒄿𒈾𒋼𒄭𒅟	STB
𒉆𒂗𒈬𒀝𒆤	SUX
𒆥𒀸𒌷𒀀𒈾𒌋𒅗𒄭𒅀	NEB
𒊭𒄿𒈾𒊑𒁺𒁴	OLB
𒀀𒀀𒈾	LTB
𒂙𒆳𒅅𒅆𒋛𒁲	STB
𒉺𒉌𒁹𒈗𒊑𒂗𒅀	MPB
𒅇𒌉𒈨𒌍𒅀𒀴𒈨𒌍𒁹𒈗𒊑𒁁𒅀𒀭𒅀𒀭𒌓𒅀	MPB
𒊭𒅖𒌅𒌗𒋗𒆰𒀀𒌓𒊹	OLB
𒁾𒁍𒋗𒀀𒌅𒀸𒋰𒄯𒋾𒌝𒈠𒀀𒉌	STB
𒀸𒊹𒌓𒌍𒌍𒀀𒈾𒊹𒋫	LTB
𒊭𒀊𒊏𒋾𒀀𒈾𒈗𒊑𒅀𒉡	MPB
𒆠𒇽𒋾𒆷𒌣𒋫	SUX
𒀭𒂗𒀯	SUX
𒆠𒉆𒋻𒊑𒁕	SUX
𒉡𒁲𒉌𒁹𒈗𒊑𒂗𒅀	MPB
𒊍𒊩𒌨𒅆𒃸𒈠	STB
𒋫𒉺𒉌𒐊𒆷𒌅𒉺𒇡𒋫	NEA
𒌉𒊩𒃻𒀸𒋗𒈫	LTB
𒊭𒊹𒀭𒉺𒍪𒋗𒌑	NEA
𒆷𒀾𒋙𒆷𒄴𒇷𒄣	NEA
𒌁𒆬𒂵	SUX
𒃻𒁀𒀀𒈾𒀭𒀫𒌓𒈬𒊭𒅆𒀀𒍪𒃲	OLB
𒀀𒈾𒈗𒅁𒋼	NEB
𒈗𒆳𒀸𒋩𒆠𒉌𒉺𒅁𒌓𒋙𒀀𒁺𒌑	NEB
𒈬𒅆𒁇𒊏𒀀	SUX
𒀸𒀊𒋾𒋼𒀀𒊏𒋾𒆷𒋼𒊐𒋙	STB
𒊹𒀉𒌉𒊩𒋢𒀀𒈾𒂍𒊹𒌓𒉡𒇽	NEB
𒌨𒊒𒁺𒅟𒀀𒈾𒆪𒋡𒁺𒈨	MPB
𒇽𒀀𒆥𒈨𒌍	NEB
𒈗𒊒𒂗𒇷𒀀𒉿𒋼𒈨𒌍	MPB
𒊹𒊑𒀴𒈨𒌍	NEA
𒀀𒄯𒊏𒍝𒀀𒈾𒈗𒁁𒉌𒐊𒀀𒉺𒅁𒉺𒊏	NEA
𒇽𒊒𒌑𒀪	NEA
𒅇𒇷𒅁𒌈𒌨𒅇𒂵𒀸𒋫𒆪	MPB
𒀸𒄷𒌓𒊮𒁉𒋙𒊹𒄑𒊒𒁀𒋙𒇽𒆭𒂍𒉿𒊑𒅖𒌈𒌑𒌓	LTB
𒁍𒁕𒂙𒆳𒋛𒁲	STB
𒅇𒀉𒋫𒊍𒍪𒉏𒇽𒈨𒌍𒌉𒆥𒊑𒅀	MPB
𒊭𒄩𒁕𒀭𒋗𒌨𒋗𒌓𒌑	OLB
𒇽𒂟𒈨𒌍𒆠	NEA
𒀴𒀭𒊊𒌷𒃲	OLB
𒊭𒉌𒉌𒉺𒋼𒋛	OLB
𒀭𒌓𒌋𒀭𒀫𒌓𒀀𒈾𒈗	NEB
𒋤𒁺𒉘	SUX
𒍥𒁕𒉽𒊹	NEA
𒇽𒈾𒁷𒊺𒆰𒈬𒈨𒌍	LTB
𒊹𒐕𒐕𒐕𒐕𒐕𒁹𒌑𒆰𒁲	SUX
𒊹𒍑𒅎𒍇𒇻𒁕𒆠𒊒𒁀𒀀𒃻𒀀𒃻𒀀𒃻	LTB
𒀭𒁺𒊑𒀀𒄭𒄿𒌈𒌋𒀭𒈨𒌍𒂍𒋙𒉡𒃮𒁉𒃻𒌗𒊻𒋢	LTB
𒌅𒊏𒀪𒊍	STB
𒀉𒁕𒁍𒌒𒅇𒀀𒈾𒉺𒉌𒉌𒅋𒋰𒆜𒋙	NEB
𒀸𒊮𒁉𒌓𒈨𒊭𒇽𒃲𒄑𒃾𒈨𒌍	NEA
𒀸𒋗𒈫𒀀𒃻𒀀𒈠𒆟𒂊𒋩	LTB
𒌨𒊒𒁍𒀀𒈾	NEA
𒂊𒈾𒋫𒉌𒌓𒁺	SUX
𒇷𒋫𒍢	MPB
𒆷𒄿𒁀𒀀𒋫𒄩𒀭𒁹	NEB
𒀸𒌋𒅗𒄭𒉌𒇸𒇷𒅟	NEA
𒀭𒈗𒌉𒁕	MPB
𒄿𒃻𒀪𒀀𒇻	NEB
𒆠𒁹𒆪	NEA
𒌋𒌋𒌋𒌋𒄘𒌦𒆬𒌓𒊹	SUX
𒀸𒆳𒊭𒈗𒂗𒅀	NEA
𒀜𒌅𒌨𒁕	NEA
𒊩𒉌𒁷𒌈𒀸𒋗𒈫𒊹𒈠𒆟𒋫𒂊𒋩𒋫𒌓𒈬𒉺𒋡𒊑𒁹𒌋𒅗𒄭	LTB
𒅇𒉿𒆷𒈬𒉡𒉌𒁹𒉆𒅀𒉿𒍝	MPB
𒅎𒈠𒁹𒀀𒍣𒊑𒀴𒅟𒈠	MPB
𒂍𒈨𒌍𒉌𒄴𒋼𒈩	NEA
𒂍𒌋𒆠𒊒𒁀𒀀𒈬𒈨𒌍𒂍𒌋𒆠𒊒𒁀𒀀𒈬𒈨𒌍𒄿𒍢𒌋𒈠𒀀𒁺𒈠𒆷𒁀𒋗𒌑	LTB
𒌗𒃶𒃶𒌓𒁺𒌓	OLB
𒀀𒈾𒆳𒈾𒄴𒊑𒈪	MPB
𒀭𒃴𒂵𒇴𒄯𒄯𒋗	SUX
𒍜𒄑𒄭𒍠𒍜𒁹𒄩𒀀𒉌	STB
𒁹𒆠𒅁𒇻	LTB
𒈗𒁁𒌑𒊺𒇻𒌋𒉌	NEA
𒃻𒉌𒅖𒂊𒉡𒈠𒀭𒀀𒉏𒀭𒂗𒆤𒀭𒂍𒀀	STB
𒌋𒌋𒈠𒆷𒀉	NEB
𒁹𒁁𒂖𒋾𒇷𒉿𒅕	OLB
𒌉𒋾𒀀𒆳𒃻𒋀𒅀	NEB
𒊭𒅖𒌅𒌷𒀭𒂗𒍪𒉡𒊒𒆠	OLB
𒀸𒌋𒅗𒊭𒀸𒃮𒋛𒌷𒆕𒄩𒀾𒈬𒌋𒉌	NEA
𒃻𒀀𒈾𒄑𒍎𒃻𒀭𒂗𒆤𒀭𒈹𒌋𒀭𒃽𒃻𒊕𒇯𒁺𒌑𒊹	LTB
𒀴𒅟𒊹𒀭𒀝𒌋𒌋𒉽	NEA
𒈗𒄖𒋾𒌝𒆠𒆤	SUX
𒁀𒊑𒂵𒁀𒊑𒂵𒍥𒍑𒀀𒈾𒆠𒁉𒃻	OLB
𒀊𒋼𒆥𒁲	NEA
𒁹𒁕𒆷𒀜𒋫𒀪	LTB
𒀀𒂠𒌅𒁕	SUX
𒁹𒌓𒀭𒈪𒃻𒌗𒁈𒋫𒃮𒁉𒊹𒈨𒌓𒈪𒀀𒈾𒌓𒈨𒌍	STB
𒅤𒈠𒈠	SUX
𒀴𒈨𒌍𒉌𒊭𒈗𒀸𒂍	NEA
𒀭𒌋𒀭𒌍	SUX
𒀭𒂊𒋫𒈪𒌅𒈫	SUX
𒆠𒁺𒌝	OLB
𒁹𒈬𒋾𒀭𒁕𒃶	OLB
𒁹𒀀𒆗𒀀	OLB
𒀀𒈾𒉺𒋫𒂊𒋙𒀠𒋙𒇽𒃻𒌋𒅗𒂍𒌌𒅅𒁀𒀪𒇽𒉿𒊹𒇲	NEB
𒁹𒀀𒄩𒌈	OLB
𒀭𒆳𒌈𒅁𒁀𒀭𒊩𒌆𒋼𒀀𒊏𒀝	SUX
𒌷𒊭𒈗	NEA
𒃻𒄴𒇷𒄣	NEB
𒊐𒋙𒅖𒆲𒌑𒅟𒀸𒉈𒅎𒃻	NEB
𒌋𒀀𒈾𒌋𒅗𒄭𒃻𒀸𒌋𒅗	NEB
𒉈𒂊𒈬𒃻𒊹𒀭𒂗𒁀𒃻𒌉𒋙𒃻	NEB
𒀀𒈾𒂟	OLB
𒊭𒆷𒀉𒁲𒅁𒁍𒌋𒀀𒈾𒌋𒈬	STB
𒊹𒅇𒊹𒄠𒋻	MPB
𒆠𒀀𒈠𒀸𒋫𒉺𒊒𒀀𒈾𒂍𒃲	MPB
𒁹𒊑𒅁𒀭𒅎𒅅𒁉	MPB
𒀭𒉌𒌓𒀸𒊮𒅕𒊑𒆪𒉡𒅕𒊑𒃻𒌉𒈨𒌍𒆪𒉡𒌉𒊩𒈨𒌍𒆪𒉡𒇻𒊺𒊑𒁍	STB
𒁲𒀀𒈾𒆪𒀀𒈾𒌋𒅗	NEB
𒁺𒄖𒆷𒉌𒆠𒁹𒈗𒊑𒂗𒅀	MPB
𒊕𒆠𒀭𒋫𒅎𒈥𒌅𒁕𒋻𒋝𒌦𒈨𒌍𒊕𒆠𒆠𒋫	LTB
𒀀𒆠𒄿𒀀𒈾𒌷𒆪𒇻𒌋𒌋	NEA
𒉡𒀀𒈾	NEB
𒊭𒀀𒈾𒈗𒂗𒅀𒀀𒋡𒁍𒌋𒉌	NEA
𒀴𒈨𒌍𒅟𒇽𒌓𒌓𒆠𒈨𒌍	NEB
𒄯𒂠𒉡𒈨𒀀	SUX
𒈠𒀪𒁺𒀸𒊮𒁉	NEA
𒆳𒊒𒋙𒌨𒅆𒌋𒌆𒁀𒉡𒊩𒌨𒀸𒋃𒃡𒅇𒌅	STB
𒅅𒁲𒁉𒈠𒀀𒄿𒋛𒅀𒀀𒋫𒅟𒉌𒈠𒀀	NEA
𒀀𒈾𒂗𒋗𒈗𒊑𒃲	MPB
𒁍𒈛𒌅	STB
𒁹𒅋𒂁𒋀	LTB
𒊹𒀭𒀫𒌓𒉽𒅕𒌋𒊹𒍝𒄫	NEB
𒀀𒈾𒌓𒈬𒍝𒀀𒌓𒀸𒀭𒁷𒁍𒌓𒀀𒄩𒀀𒈩𒀀𒈾	LTB
𒅇𒀀𒈾𒆪𒂊𒁍𒍑𒀀𒈾	MPB
𒆠𒈠𒆷𒁉𒊑𒋗𒁹	STB
𒌓𒈬𒍝𒀀𒌓𒈾𒋗𒌑𒄑𒊒𒁀𒈨𒌍𒌋𒂍𒋗𒈫𒈬𒈨𒌍𒃻𒊩𒇷𒈾𒆪𒋙𒃻𒈬𒋙𒊹	LTB
𒌋𒀀𒈾𒌋𒅗𒁳𒁉𒀀𒂵𒉡𒋾	NEB
𒉽𒊹𒈨𒊹𒆳𒀸𒋩𒀀𒀀	NEA
𒀀𒈾𒌷𒇹𒄩𒀸𒊮𒁉	NEA
𒌌𒋫𒋛𒅅𒄒𒈠𒌌	NEB
𒋞𒅇𒈧𒁉	SUX
𒉺𒇻𒁉	SUX
𒊹𒊹𒉣𒇬𒆸𒈠𒀯𒄈𒋰𒀸𒊮𒋙𒁺	STB
𒀭𒋀𒆠𒈗𒀭𒆠𒀀	SUX
𒀭𒊏𒈪𒈬𒀭𒅎	STB
𒀀𒈾𒀀𒊮𒈨𒂊𒊭𒆠	OLB
𒀀𒃻𒀀𒃻	LTB
𒌋𒇽𒆬𒁴𒌑𒌓𒈬𒈨𒌍𒅅𒁉𒅆𒁺𒄑𒊒𒁀𒈨𒌍𒈬𒈨𒌍𒃻𒌗𒊻𒋢	LTB
𒇽𒌷𒌅𒊩𒋾𒆠𒅇𒉌𒅖𒈪	MPB
𒁹𒄭𒂵𒈠𒀠𒀭	OLB
𒊹𒁹𒁀𒃻𒀀	LTB
𒇻𒆠𒅔𒉡	NEA
𒆠𒋀𒁀𒀭𒌇	SUX
𒀴𒈨𒌍𒀀𒊏𒁺	MPB
𒌋𒄖𒋾𒌝𒄿𒊏𒈨𒄿𒁕𒆪𒀸𒋳𒊏𒊓𒁍𒁕𒀀𒆪𒋗𒉪	STB
𒊹𒊕𒀴𒊹𒌉	OLB
𒇽𒌉𒅆𒅁𒊑	MPB
𒈗𒋀𒀊𒆠𒈠𒅟	SUX
𒄿𒌑𒈨	NEA
𒋼𒊑𒂊𒋼𒇽𒄬𒈨𒌍𒌌𒄿𒋫𒀮𒉺𒇻	STB
𒀭𒀝𒌋𒀭𒀫𒌓𒀀𒈾𒈗	NEA
𒇽𒈨𒌍𒅀𒅋𒋼𒆥	MPB
𒋢𒄰𒁾𒊬𒌉	STB
𒄉𒃶𒁉𒇲	SUX
𒃮𒁉𒀀𒈾𒊹𒂆𒆬𒌓𒄑𒋫𒌁𒊏𒉡𒃻𒁹𒀭𒋾𒀪𒄿𒆪𒋢	LTB
𒄿𒅋𒆷𒂵𒄠𒄿𒈾𒆳𒉡𒄩𒀸𒊺	MPB
𒋳𒈠𒅆𒅕	STB
𒊹𒊹𒊹𒆳𒈠𒆠𒋙𒀉𒋼𒌅𒀸𒆳	STB
𒁹𒁁𒂖𒊭𒁺𒉌	OLB
𒊌𒋗𒋳𒈠𒆷𒌑𒉿𒅆𒊒	MPB
𒈬𒈾𒋛𒀀	SUX
𒅇𒀀𒈾𒉺𒀭	NEB
𒊭𒀠𒈠𒀜	OLB
𒊹𒊹𒊹𒊹𒊹𒊹𒄥𒊺𒊹	SUX
𒁹𒀭𒂗𒍪𒁁𒂖𒉌𒉌	OLB
𒉌𒄩𒀜𒌋𒌆𒆷𒋙𒉡𒂊𒁍𒋗	NEA
𒈗𒈥𒌅𒋙𒌓𒆕𒈠𒀀𒁉𒅅𒋾𒆳𒉽𒋙𒃻𒀭	STB
𒌷𒈾𒌑𒆉𒉌𒍠𒁉𒀀𒈬𒁕𒀀𒈿𒀀𒀭	SUX
𒌗𒋗𒆰𒀀𒌓𒊹	OLB
𒃻𒈗𒁁𒉌𒐊𒀉𒋾𒐊𒄿𒁳𒁍𒁍𒈠𒄿𒌉𒊏	NEB
𒌑𒄫𒈠𒊹𒀭𒅎	NEA
𒀀𒈾𒂗𒉣𒅀𒀠𒋃	NEA
𒇽𒂗𒈨𒌍𒄭𒂅𒃻𒈗𒁁𒉌𒐊𒋙𒉡	NEB
𒀕𒆠𒌗𒁈𒌓𒊹𒈬𒊹	LTB
𒁹𒁹𒁹𒌜𒂍𒀀𒆤	SUX
𒊭𒈾𒈾𒁺	MPB
𒀴𒀭𒊩𒌆𒋜𒀭𒈾	OLB
𒀭𒍣𒊺𒈫	SUX
𒁹𒁀𒃻𒀀𒌉𒃻𒊹𒌋𒈪𒋻𒌑𒊕𒆠𒆠𒋫𒅎𒆳𒊏𒁕𒈬𒍮𒌑𒃻𒁉𒈩𒋙𒉡	LTB
𒀭𒁲𒋗	SUX
𒇯𒇻𒅁𒉺𒀾	NEA
𒀭𒌷𒀠𒊹𒊏𒈠𒀭𒍝𒀜	SUX
𒊹𒀭𒀝𒂟𒅕	NEB
𒆠𒊒𒁀𒀀𒈬𒈨𒌍𒄿𒍢𒄿𒌋𒈠𒀀𒁺𒈠𒆷𒁀𒋗𒌑𒃮𒁉𒀀𒈾𒊹𒂆𒆬𒌓	LTB
𒅇𒋾𒅅𒁉𒌷𒆠𒄿𒍣𒁍𒋗	MPB
𒅀𒃼𒁀	NEA
𒀭𒁲𒅋𒁀𒅟𒌦	SUX
𒊓𒋗𒈬	SUX
𒀀𒈾𒈗𒂗𒅀𒅖𒌅	MPB
𒀀𒆗𒅅𒈠𒂙𒆳𒋛𒁲	STB
𒍣𒈨𒌍𒋙𒉡𒄿𒊑𒂗𒋙𒉡𒋾𒈠	NEB
𒂟𒈨𒌍𒋙𒌑𒀀𒉌𒉌𒂟𒈨𒌍𒋙𒆷𒋗𒊹𒈗	NEB
𒀭𒈗𒀭𒄭𒄊𒋗	SUX
𒀀𒈾𒁹𒉌𒅎𒈬𒊑𒅀𒈗𒆳𒈪𒄑𒊑𒄿𒆥𒉈𒈠	MPB
𒁀𒊑𒂵𒁀𒊑𒂵𒑏𒑏𒑏𒑏	STB
𒀭𒊩𒌆𒉄𒁍	SUX
𒁹𒅎𒈨𒅕𒌈	OLB
𒊹𒊓𒋛𒀀𒀀𒀭𒌋𒀀𒆗𒈨𒌍𒌝	STB
𒄥𒄥𒄥𒄥𒑏𒑏𒊺𒋗𒋾𒀀	OLB
𒅇𒀀𒉡𒌝𒈠𒀀𒈾𒆪	MPB
𒊹𒉽𒇷𒂊𒀀𒇻𒋗𒌋𒀀𒁺	NEA
𒁹𒀀𒉿𒅋𒀭𒅎𒉺𒉺	OLB
𒀸𒉿𒄿𒌦𒈨𒌍𒃻	STB
𒄿𒊏𒀀𒈬𒀠𒋼𒈨	NEB
𒃻𒋗𒀭𒂗𒍪𒊺𒈪𒉺𒀀𒋛𒊑	OLB
𒊩𒌉𒅟𒇻𒍝𒊏𒈠𒌉𒊩𒉌	OLB
𒌓𒊹𒄰𒀸𒅆𒀭𒄖𒆷	STB
𒇽𒉽𒆗𒉡𒆳𒄿𒋛𒀪	STB
𒂍𒃶𒅅	SUX
𒄑𒆪𒈨𒆳𒌵𒆠	STB
𒌋𒅗𒄭𒉺𒉌𒃻𒋀𒋙𒊩𒋙𒀸𒂍𒌆𒄖𒅘𒆪𒌋𒍏𒊿𒌉𒈬𒈨𒌍	LTB
𒁹𒋀𒀪𒌑𒌅𒀀𒁲𒊹𒀀𒈾𒌉𒃻	LTB
𒉽𒉡𒀀𒈾𒅀𒅆	MPB
𒆳𒋾𒀀𒂵𒀀𒀀𒈾𒆳𒋙𒆷𒄿𒋻	NEB
𒃻𒋗𒀭𒂗𒍪𒊑𒈨𒉌𒉺𒋼𒋛	OLB
𒆜𒃻𒅆𒁲𒀀𒈾𒄊𒊹𒋙𒉡	NEB
𒌷𒆠𒀉𒋾𒅇𒀠𒇻𒌑	MPB
𒄿𒁕𒌅𒍑𒋙𒂊𒋰𒊒	NEA
𒃮𒋗𒃻𒉡𒌇	SUX
𒃻𒋗𒋢𒌝𒉺𒈥𒌅	OLB
𒀀𒀀𒈾𒌓𒈬𒍝𒀀𒌓𒀉𒋫𒁷	LTB
𒈠𒀀𒊹𒂗𒆷𒊑𒂊𒄭𒈠𒀀	NEA
𒌓𒈨𒌍𒄭𒂵𒈨𒌍𒆕𒋾	STB
𒆠𒉘𒀭𒂗𒆤	SUX
𒌗𒍩𒀀𒌓𒊹	OLB
𒁹𒆠𒁷𒀭𒀫𒌓	LTB
𒊭𒄿𒈾𒌷𒂦𒆠	OLB
𒉆𒄯𒋾	OLB
𒀸𒄷𒌓𒊮𒁉𒋙𒊑𒁍𒌑𒀸𒂍𒋗𒈫𒌋𒌋𒌆𒁀𒉌𒋙𒌋𒊿𒁉𒈨𒌍𒋙𒌈𒋗	LTB
𒀀𒄩𒌈	OLB
𒊩𒆳𒀭𒈥𒌅	OLB
𒆷𒇽𒂡𒆪𒌑𒌓𒆷𒇽𒋗𒃻𒉡𒌑𒌓𒆷𒇽𒌉𒆕𒌑𒌓𒆷𒇽𒀴𒈗𒌑𒌓	LTB
𒃻𒀀𒈾𒆏𒅋𒋃𒌋𒉌𒄈𒈨𒌍𒈠𒇷𒆰𒀀𒋙	STB
𒌓𒌍𒌍𒈨𒌍𒅇𒃮𒁉𒃻𒀀𒈾𒄑𒊒𒁀𒇽𒋋𒌑𒌓𒈬𒈨𒌍	LTB
𒌝𒈠𒁹𒍣𒅎𒊑𒁕	MPB
𒀭𒌑𒅎𒋛𒁲𒁕𒂍𒁹𒀭𒈾𒈾𒀀𒈬𒌋𒋀𒈨𒌍𒋙𒌉𒃻𒊹𒌑	LTB
𒀠𒋰𒆜𒋙𒈗	NEB
𒆷𒋡𒌁𒋫𒋫𒊹𒊐𒀀𒁲	STB
𒀀𒈾𒉚𒌀𒈨𒌍𒀀𒈾𒌉𒃻	LTB
𒇻𒌋𒅟𒈬𒋢	NEA
𒀀𒈾𒆪𒌋𒊑𒃻𒁖𒃶𒉌𒅟𒍢𒋾	STB
𒄿𒊑𒆪𒄑	NEA
𒁹𒀭𒋗𒅁𒉌𒋗	OLB
𒊭𒈾𒄰𒋾	OLB
𒊹𒀭𒁈𒅆𒂟𒂵𒀭𒊩𒌆𒂗𒆤𒆠𒆤	SUX
𒁹𒀭𒂗𒍪𒀀𒁍𒋗	SUX
𒆠𒄿𒉌𒅖𒈬𒌋𒈗𒁁𒉌𒀀𒉌	NEB
𒊹𒊹𒀸𒌗𒀊𒌓𒊹𒆚𒅆	STB
𒉈𒉡𒌑𒆗𒇻𒌒𒁍𒁴	STB
𒀭𒌓𒁕𒀜𒋗	SUX
𒃻𒌷𒁲𒊑	NEB
